date,state,positive,negative,pending,dateChecked,death,hospitalized,total,totalTestResults,posNeg,fips,deathIncrease,hospitalizedIncrease,negativeIncrease,positiveIncrease,totalTestResultsIncrease
20200413,AK,277,7553,null,2020-04-13 20:00:00,8,32,7830,7830,7830,2,0,1,-213,5,-208
20200430,AK,355,18764,null,2020-04-30 20:00:00,9,null,19119,19119,19119,2,0,0,0,0,0
20200323,AK,22,946,null,2020-03-23 20:00:00,0,0,968,968,968,2,0,0,0,0,0
20200316,AK,1,143,null,2020-03-16 20:00:00,0,null,144,144,144,2,0,0,0,0,0
20200315,AK,1,143,null,2020-03-15 20:00:00,0,null,144,144,144,2,0,0,0,0,0
20200312,AK,0,46,14,2020-03-12 20:00:00,0,null,60,46,46,2,0,0,0,0,0
20200310,AK,0,23,9,2020-03-10 20:00:00,0,null,32,23,23,2,0,0,0,0,0
20200423,AK,337,11824,null,2020-04-23 20:00:00,9,null,12161,12161,12161,2,0,0,0,2,2
20200308,AK,0,14,6,2020-03-08 20:00:00,0,null,20,14,14,2,0,0,2,0,2
20200307,AK,0,12,2,2020-03-07 21:00:00,0,null,14,12,12,2,0,0,4,0,4
20200309,AK,0,23,9,2020-03-09 20:00:00,0,null,32,23,23,2,0,0,9,0,9
20200313,AK,1,59,null,2020-03-13 20:00:00,0,null,60,60,60,2,0,0,13,1,14
20200311,AK,0,46,14,2020-03-11 20:00:00,0,null,60,46,46,2,0,0,23,0,23
20200404,AK,171,5869,null,2020-04-04 20:00:00,5,16,6040,6040,6040,2,2,1,10,14,24
20200319,AK,6,432,null,2020-03-19 20:00:00,0,null,438,438,438,2,0,0,26,0,26
20200407,AK,213,6700,null,2020-04-07 20:00:00,6,23,6913,6913,6913,2,0,0,8,22,30
20200324,AK,36,986,null,2020-03-24 20:00:00,0,0,1022,1022,1022,2,0,0,40,14,54
20200331,AK,119,3594,null,2020-03-31 20:00:00,3,7,3713,3713,3713,2,0,0,54,5,59
20200416,AK,300,8435,null,2020-04-16 20:00:00,9,35,8735,8735,8735,2,0,1,64,7,71
20200321,AK,14,758,null,2020-03-21 20:00:00,0,0,772,772,772,2,0,0,72,2,74
20200318,AK,6,406,null,2020-03-18 20:00:00,0,null,412,412,412,2,0,0,72,3,75
20200427,AK,345,15911,null,2020-04-27 20:00:00,9,null,16256,16256,16256,2,0,0,75,4,79
20200314,AK,1,143,null,2020-03-14 20:00:00,0,null,144,144,144,2,0,0,84,0,84
20200424,AK,339,11942,null,2020-04-24 20:00:00,9,null,12281,12281,12281,2,0,0,118,2,120
20200504,AK,370,21353,null,2020-05-04 20:00:00,9,null,21723,21723,21723,2,0,0,143,2,145
20200409,AK,235,6988,null,2020-04-09 20:00:00,7,27,7223,7223,7223,2,0,0,146,9,155
20200408,AK,226,6842,null,2020-04-08 20:00:00,7,27,7068,7068,7068,2,1,4,142,13,155
20200326,AK,59,1801,null,2020-03-26 20:00:00,1,3,1860,1860,1860,2,0,2,152,17,169
20200503,AK,368,21210,null,2020-05-03 20:00:00,9,null,21578,21578,21578,2,0,0,176,3,179
20200317,AK,3,334,null,2020-03-17 20:00:00,0,null,337,337,337,2,0,0,191,2,193
20200322,AK,22,946,null,2020-03-22 20:00:00,0,0,968,968,968,2,0,0,188,8,196
20200418,AK,314,9341,null,2020-04-18 20:00:00,9,36,9655,9655,9655,2,0,0,200,5,205
20200410,AK,246,7186,null,2020-04-10 20:00:00,7,28,7432,7432,7432,2,0,1,198,11,209
20200420,AK,321,9803,null,2020-04-20 20:00:00,9,36,10124,10124,10124,2,0,0,227,2,229
20200419,AK,319,9576,null,2020-04-19 20:00:00,9,36,9895,9895,9895,2,0,0,235,5,240
20200405,AK,185,6099,null,2020-04-05 20:00:00,6,20,6284,6284,6284,2,1,4,230,14,244
20200320,AK,12,686,null,2020-03-20 20:00:00,0,null,698,698,698,2,0,0,254,6,260
20200411,AK,257,7475,null,2020-04-11 20:00:00,8,31,7732,7732,7732,2,1,3,289,11,300
20200412,AK,272,7766,null,2020-04-12 20:00:00,8,31,8038,8038,8038,2,0,0,291,15,306
20200415,AK,293,8371,null,2020-04-15 20:00:00,9,34,8664,8664,8664,2,0,2,308,8,316
20200330,AK,114,3540,null,2020-03-30 20:00:00,3,7,3654,3654,3654,2,1,1,308,12,320
20200329,AK,102,3232,null,2020-03-29 20:00:00,2,6,3334,3334,3334,2,0,1,396,17,413
20200402,AK,143,4879,null,2020-04-02 20:00:00,3,9,5022,5022,5022,2,0,0,409,10,419
20200426,AK,341,15836,null,2020-04-26 20:00:00,9,null,16177,16177,16177,2,0,0,443,2,445
20200414,AK,285,8063,null,2020-04-14 20:00:00,9,32,8348,8348,8348,2,1,0,510,8,518
20200327,AK,69,2319,13,2020-03-27 20:00:00,1,3,2401,2388,2388,2,0,0,518,10,528
20200328,AK,85,2836,null,2020-03-28 20:00:00,2,5,2921,2921,2921,2,1,2,517,16,533
20200406,AK,191,6692,null,2020-04-06 20:00:00,6,23,6883,6883,6883,2,0,3,593,6,599
20200325,AK,42,1649,null,2020-03-25 20:00:00,1,1,1691,1691,1691,2,1,1,663,6,669
20200507,AK,374,23967,null,2020-05-07 20:00:00,10,null,24341,24341,24341,2,0,0,684,2,686
20200417,AK,309,9141,null,2020-04-17 20:00:00,9,36,9450,9450,9450,2,0,1,706,9,715
20200428,AK,351,16738,null,2020-04-28 20:00:00,9,null,17089,17089,17089,2,0,0,827,6,833
20200401,AK,133,4470,null,2020-04-01 20:00:00,3,9,4603,4603,4603,2,0,2,876,14,890
20200510,AK,379,26985,null,2020-05-10 20:00:00,10,null,27364,27364,27364,2,0,0,914,1,915
20200506,AK,372,23283,null,2020-05-06 20:00:00,10,null,23655,23655,23655,2,1,0,962,1,963
20200505,AK,371,22321,null,2020-05-05 20:00:00,9,null,22692,22692,22692,2,0,0,968,1,969
20200509,AK,378,26071,null,2020-05-09 20:00:00,10,null,26449,26449,26449,2,0,0,975,1,976
20200403,AK,157,5859,null,2020-04-03 20:00:00,3,15,6016,6016,6016,2,0,6,980,14,994
20200421,AK,329,10790,null,2020-04-21 20:00:00,9,36,11119,11119,11119,2,0,0,987,8,995
20200422,AK,335,11824,null,2020-04-22 20:00:00,9,36,12159,12159,12159,2,0,0,1034,6,1040
20200502,AK,365,21034,null,2020-05-02 20:00:00,9,null,21399,21399,21399,2,0,0,1073,1,1074
20200508,AK,377,25096,null,2020-05-08 20:00:00,10,null,25473,25473,25473,2,0,0,1129,3,1132
20200501,AK,364,19961,null,2020-05-01 20:00:00,9,null,20325,20325,20325,2,0,0,1197,9,1206
20200511,AK,381,28299,null,2020-05-11 20:00:00,10,null,28680,28680,28680,2,0,0,1314,2,1316
20200429,AK,355,18764,null,2020-04-29 20:00:00,9,null,19119,19119,19119,2,0,0,2026,4,2030
20200425,AK,339,15393,null,2020-04-25 20:00:00,9,null,15732,15732,15732,2,0,0,3451,0,3451
20200306,AK,0,8,1,2020-03-06 21:00:00,0,null,9,8,8,2,null,null,null,null,null
20200312,AL,0,10,null,2020-03-12 20:00:00,null,null,10,10,10,1,0,0,0,0,0
20200310,AL,0,0,0,2020-03-10 20:00:00,null,null,0,0,0,1,0,0,0,0,0
20200309,AL,0,null,null,2020-03-09 20:00:00,null,null,0,0,0,1,0,0,0,0,0
20200308,AL,0,null,null,2020-03-08 20:00:00,null,null,0,0,0,1,0,0,0,0,0
20200313,AL,1,11,null,2020-03-13 20:00:00,null,null,12,12,12,1,0,0,1,1,2
20200317,AL,36,28,null,2020-03-17 20:00:00,0,null,64,64,64,1,0,0,0,8,8
20200318,AL,46,28,null,2020-03-18 20:00:00,0,null,74,74,74,1,0,0,0,10,10
20200311,AL,0,10,null,2020-03-11 20:00:00,null,null,10,10,10,1,0,0,10,0,10
20200315,AL,12,28,46,2020-03-15 20:00:00,0,null,86,40,40,1,0,0,6,6,12
20200320,AL,81,28,null,2020-03-20 20:00:00,0,null,109,109,109,1,0,0,0,13,13
20200316,AL,28,28,40,2020-03-16 20:00:00,0,null,96,56,56,1,0,0,0,16,16
20200314,AL,6,22,46,2020-03-14 20:00:00,null,null,74,28,28,1,0,0,11,5,16
20200319,AL,68,28,null,2020-03-19 20:00:00,0,null,96,96,96,1,0,0,0,22,22
20200321,AL,124,28,null,2020-03-21 20:00:00,0,null,152,152,152,1,0,0,0,43,43
20200424,AL,5832,46863,null,2020-04-24 20:00:00,197,768,52695,52695,52695,1,0,0,0,54,54
20200328,AL,696,4184,null,2020-03-28 20:00:00,3,null,4880,4880,4880,1,0,0,0,109,109
20200329,AL,806,4184,null,2020-03-29 20:00:00,4,null,4990,4990,4990,1,1,0,0,110,110
20200407,AL,2119,12797,null,2020-04-07 20:00:00,56,271,14916,14916,14916,1,6,31,0,151,151
20200420,AL,5025,40875,null,2020-04-20 20:00:00,167,641,45900,45900,45900,1,13,0,0,188,188
20200410,AL,2968,18058,null,2020-04-10 20:00:00,80,368,21026,21026,21026,1,6,35,0,199,199
20200411,AL,3191,18058,null,2020-04-11 20:00:00,91,402,21249,21249,21249,1,11,34,0,223,223
20200323,AL,167,1665,null,2020-03-23 20:00:00,0,null,1832,1832,1832,1,0,0,201,29,230
20200422,AL,5465,43295,null,2020-04-22 20:00:00,194,730,48760,48760,48760,1,17,31,0,234,234
20200502,AL,7434,84775,null,2020-05-02 20:00:00,288,1023,92209,92209,92209,1,9,15,0,276,276
20200503,AL,7725,84775,null,2020-05-03 20:00:00,290,1035,92500,92500,92500,1,2,12,0,291,291
20200412,AL,3525,18058,null,2020-04-12 20:00:00,93,437,21583,21583,21583,1,2,35,0,334,334
20200427,AL,6499,67498,null,2020-04-27 20:00:00,222,872,73997,73997,73997,1,6,27,217,229,446
20200324,AL,215,2106,null,2020-03-24 20:00:00,0,null,2321,2321,2321,1,0,0,441,48,489
20200325,AL,283,2529,null,2020-03-25 20:00:00,0,null,2812,2812,2812,1,0,0,423,68,491
20200401,AL,1077,6697,null,2020-04-01 20:00:00,26,null,7774,7774,7774,1,13,0,399,96,495
20200327,AL,587,4184,null,2020-03-27 20:00:00,3,null,4771,4771,4771,1,2,0,591,81,672
20200331,AL,981,6298,null,2020-03-31 20:00:00,13,null,7279,7279,7279,1,7,0,604,122,726
20200403,AL,1432,8187,null,2020-04-03 20:00:00,35,null,9619,9619,9619,1,3,0,684,199,883
20200415,AL,4113,29964,null,2020-04-15 20:00:00,121,525,34077,34077,34077,1,11,32,723,237,960
20200402,AL,1233,7503,null,2020-04-02 20:00:00,32,null,8736,8736,8736,1,6,0,806,156,962
20200404,AL,1580,9273,null,2020-04-04 20:00:00,43,212,10853,10853,10853,1,8,212,1086,148,1234
20200326,AL,506,3593,null,2020-03-26 20:00:00,1,null,4099,4099,4099,1,1,0,1064,223,1287
20200322,AL,138,1464,null,2020-03-22 20:00:00,0,null,1602,1602,1602,1,0,0,1436,14,1450
20200417,AL,4530,33318,null,2020-04-17 20:00:00,144,594,37848,37848,37848,1,11,41,1272,185,1457
20200330,AL,859,5694,null,2020-03-30 20:00:00,6,null,6553,6553,6553,1,2,0,1510,53,1563
20200406,AL,1968,12797,null,2020-04-06 20:00:00,50,240,14765,14765,14765,1,5,9,1515,172,1687
20200409,AL,2769,18058,null,2020-04-09 20:00:00,74,333,20827,20827,20827,1,8,19,1305,400,1705
20200428,AL,6687,69140,null,2020-04-28 20:00:00,242,911,75827,75827,75827,1,20,39,1642,188,1830
20200510,AL,9777,117644,null,2020-05-10 20:00:00,393,1240,127421,127421,127421,1,5,12,1717,210,1927
20200511,AL,10009,119435,null,2020-05-11 20:00:00,401,1256,129444,129444,129444,1,8,16,1791,232,2023
20200426,AL,6270,67281,null,2020-04-26 20:00:00,216,845,73551,73551,73551,1,4,6,2074,133,2207
20200405,AL,1796,11282,null,2020-04-05 20:00:00,45,231,13078,13078,13078,1,2,19,2009,216,2225
20200416,AL,4345,32046,null,2020-04-16 20:00:00,133,553,36391,36391,36391,1,12,28,2082,232,2314
20200421,AL,5231,43295,null,2020-04-21 20:00:00,177,699,48526,48526,48526,1,10,58,2420,206,2626
20200506,AL,8581,100935,null,2020-05-06 20:00:00,340,1158,109516,109516,109516,1,27,51,2454,296,2750
20200419,AL,4837,40875,null,2020-04-19 20:00:00,154,641,45712,45712,45712,1,8,21,2992,182,3174
20200505,AL,8285,98481,null,2020-05-05 20:00:00,313,1107,106766,106766,106766,1,17,43,3389,260,3649
20200423,AL,5778,46863,null,2020-04-23 20:00:00,197,768,52641,52641,52641,1,3,38,3568,313,3881
20200414,AL,3876,29241,null,2020-04-14 20:00:00,110,493,33117,33117,33117,1,11,36,3793,142,3935
20200408,AL,2369,16753,null,2020-04-08 20:00:00,66,314,19122,19122,19122,1,10,43,3956,250,4206
20200429,AL,6842,73607,null,2020-04-29 20:00:00,245,945,80449,80449,80449,1,3,34,4467,155,4622
20200418,AL,4655,37883,null,2020-04-18 20:00:00,146,620,42538,42538,42538,1,2,26,4565,125,4690
20200501,AL,7158,84775,null,2020-05-01 20:00:00,279,1008,91933,91933,91933,1,10,30,4598,139,4737
20200508,AL,9221,110893,null,2020-05-08 20:00:00,375,1207,120114,120114,120114,1,26,29,4618,323,4941
20200509,AL,9567,115927,null,2020-05-09 20:00:00,388,1228,125494,125494,125494,1,13,21,5034,346,5380
20200507,AL,8898,106275,null,2020-05-07 20:00:00,349,1178,115173,115173,115173,1,9,20,5340,317,5657
20200430,AL,7019,80177,null,2020-04-30 20:00:00,269,978,87196,87196,87196,1,24,33,6570,177,6747
20200413,AL,3734,25448,null,2020-04-13 20:00:00,99,457,29182,29182,29182,1,6,20,7390,209,7599
20200504,AL,8025,95092,null,2020-05-04 20:00:00,296,1064,103117,103117,103117,1,6,29,10317,300,10617
20200425,AL,6137,65207,null,2020-04-25 20:00:00,212,839,71344,71344,71344,1,15,71,18344,305,18649
20200307,AL,0,null,null,2020-03-07 21:00:00,null,null,0,0,0,1,null,null,null,null,null
20200510,AR,3747,61781,null,2020-05-10 20:00:00,88,471,65528,65528,65528,5,0,0,0,0,0
20200311,AR,0,12,14,2020-03-11 20:00:00,null,null,26,12,12,5,0,0,0,0,0
20200310,AR,0,12,3,2020-03-10 20:00:00,null,null,15,12,12,5,0,0,0,0,0
20200308,AR,0,6,0,2020-03-08 20:00:00,null,null,6,6,6,5,0,0,0,0,0
20200307,AR,0,6,0,2020-03-07 21:00:00,null,null,6,6,6,5,0,0,0,0,0
20200309,AR,0,12,0,2020-03-09 20:00:00,null,null,12,12,12,5,0,0,6,0,6
20200313,AR,9,30,22,2020-03-13 20:00:00,null,null,61,39,39,5,0,0,6,3,9
20200312,AR,6,24,20,2020-03-12 20:00:00,null,null,50,30,30,5,0,0,12,6,18
20200316,AR,22,132,14,2020-03-16 20:00:00,null,null,168,154,154,5,0,0,29,6,35
20200314,AR,12,65,26,2020-03-14 20:00:00,null,null,103,77,77,5,0,0,35,3,38
20200315,AR,16,103,30,2020-03-15 20:00:00,null,null,149,119,119,5,0,0,38,4,42
20200318,AR,33,236,50,2020-03-18 20:00:00,null,null,319,269,269,5,0,0,39,11,50
20200317,AR,22,197,41,2020-03-17 20:00:00,null,null,260,219,219,5,0,0,65,0,65
20200419,AR,1781,22428,null,2020-04-19 20:00:00,40,291,24209,24209,24209,5,2,0,26,42,68
20200324,AR,218,947,null,2020-03-24 20:00:00,0,null,1165,1165,1165,5,0,0,41,44,85
20200327,AR,381,1545,null,2020-03-27 20:00:00,3,null,1926,1926,1926,5,0,0,41,46,87
20200319,AR,46,310,113,2020-03-19 20:00:00,null,null,469,356,356,5,0,0,74,13,87
20200320,AR,96,351,203,2020-03-20 20:00:00,null,null,650,447,447,5,0,0,41,50,91
20200329,AR,426,3027,null,2020-03-29 20:00:00,6,null,3453,3453,3453,5,1,0,89,22,111
20200326,AR,335,1504,null,2020-03-26 20:00:00,3,null,1839,1839,1839,5,1,0,67,55,122
20200322,AR,165,711,119,2020-03-22 20:00:00,0,null,995,876,876,5,0,0,144,47,191
20200505,AR,3496,51139,null,2020-05-05 20:00:00,80,453,54635,54635,54635,5,-1,15,155,38,193
20200323,AR,174,906,null,2020-03-23 20:00:00,0,null,1080,1080,1080,5,0,0,195,9,204
20200428,AR,3111,37560,null,2020-04-28 20:00:00,52,null,40671,40671,40671,5,2,0,120,94,214
20200321,AR,118,567,154,2020-03-21 20:00:00,null,null,839,685,685,5,0,0,216,22,238
20200414,AR,1480,19651,null,2020-04-14 20:00:00,30,130,21131,21131,21131,5,0,0,257,70,327
20200409,AR,1119,13832,null,2020-04-09 20:00:00,21,130,14951,14951,14951,5,3,0,302,119,421
20200325,AR,280,1437,null,2020-03-25 20:00:00,2,null,1717,1717,1717,5,2,0,490,62,552
20200402,AR,643,7880,null,2020-04-02 20:00:00,12,100,8523,8523,8523,5,2,10,526,59,585
20200418,AR,1739,22402,null,2020-04-18 20:00:00,38,291,24141,24141,24141,5,1,291,603,44,647
20200404,AR,743,9627,null,2020-04-04 20:00:00,14,106,10370,10370,10370,5,2,1,632,39,671
20200415,AR,1569,20265,null,2020-04-15 20:00:00,33,130,21834,21834,21834,5,3,0,614,89,703
20200331,AR,523,5959,null,2020-03-31 20:00:00,8,null,6482,6482,6482,5,1,0,697,50,747
20200407,AR,946,12692,null,2020-04-07 20:00:00,16,148,13638,13638,13638,5,0,11,722,71,793
20200417,AR,1695,21799,null,2020-04-17 20:00:00,37,null,23494,23494,23494,5,0,0,744,75,819
20200416,AR,1620,21055,null,2020-04-16 20:00:00,37,null,22675,22675,22675,5,4,0,790,51,841
20200405,AR,830,10412,null,2020-04-05 20:00:00,16,130,11242,11242,11242,5,2,24,785,87,872
20200421,AR,2227,25214,null,2020-04-21 20:00:00,43,291,27441,27441,27441,5,1,0,584,304,888
20200408,AR,1000,13530,null,2020-04-08 20:00:00,18,130,14530,14530,14530,5,2,-18,838,54,892
20200427,AR,3017,37440,null,2020-04-27 20:00:00,50,null,40457,40457,40457,5,1,0,912,76,988
20200507,AR,3611,56384,null,2020-05-07 20:00:00,87,462,59995,59995,59995,5,2,9,949,43,992
20200413,AR,1410,19394,null,2020-04-13 20:00:00,30,130,20804,20804,20804,5,3,0,952,130,1082
20200412,AR,1280,18442,null,2020-04-12 20:00:00,27,130,19722,19722,19722,5,3,0,1090,54,1144
20200403,AR,704,8995,null,2020-04-03 20:00:00,12,105,9699,9699,9699,5,0,5,1115,61,1176
20200501,AR,3321,46355,null,2020-05-01 20:00:00,64,414,49676,49676,49676,5,3,12,1231,66,1297
20200503,AR,3431,49459,null,2020-05-03 20:00:00,76,427,52890,52890,52890,5,3,13,1249,59,1308
20200426,AR,2941,36528,null,2020-04-26 20:00:00,49,291,39469,39469,39469,5,2,0,1304,112,1416
20200328,AR,404,2938,null,2020-03-28 20:00:00,5,null,3342,3342,3342,5,2,0,1393,23,1416
20200401,AR,584,7354,null,2020-04-01 20:00:00,10,90,7938,7938,7938,5,2,90,1395,61,1456
20200411,AR,1226,17352,null,2020-04-11 20:00:00,24,130,18578,18578,18578,5,1,0,1403,55,1458
20200509,AR,3747,61781,null,2020-05-09 20:00:00,88,471,65528,65528,65528,5,0,5,1481,53,1534
20200504,AR,3458,50984,null,2020-05-04 20:00:00,81,438,54442,54442,54442,5,5,11,1525,27,1552
20200406,AR,875,11970,null,2020-04-06 20:00:00,16,137,12845,12845,12845,5,0,7,1558,45,1603
20200423,AR,2465,29125,null,2020-04-23 20:00:00,45,291,31590,31590,31590,5,3,0,1688,189,1877
20200502,AR,3372,48210,null,2020-05-02 20:00:00,73,414,51582,51582,51582,5,9,0,1855,51,1906
20200410,AR,1171,15949,null,2020-04-10 20:00:00,23,130,17120,17120,17120,5,2,0,2117,52,2169
20200422,AR,2276,27437,null,2020-04-22 20:00:00,42,291,29713,29713,29713,5,-1,0,2223,49,2272
20200330,AR,473,5262,null,2020-03-30 20:00:00,7,null,5735,5735,5735,5,1,0,2235,47,2282
20200420,AR,1923,24630,null,2020-04-20 20:00:00,42,291,26553,26553,26553,5,2,0,2202,142,2344
20200425,AR,2829,35224,null,2020-04-25 20:00:00,47,291,38053,38053,38053,5,2,0,2387,88,2475
20200430,AR,3255,45124,null,2020-04-30 20:00:00,61,402,48379,48379,48379,5,2,13,2867,63,2930
20200511,AR,4034,64996,null,2020-05-11 20:00:00,94,480,69030,69030,69030,5,6,9,3215,287,3502
20200424,AR,2741,32837,null,2020-04-24 20:00:00,45,291,35578,35578,35578,5,0,0,3712,276,3988
20200508,AR,3694,60300,null,2020-05-08 20:00:00,88,466,63994,63994,63994,5,1,4,3916,83,3999
20200506,AR,3568,55435,null,2020-05-06 20:00:00,85,453,59003,59003,59003,5,5,0,4296,72,4368
20200429,AR,3192,42257,null,2020-04-29 20:00:00,59,389,45449,45449,45449,5,7,389,4697,81,4778
20200306,AR,0,6,0,2020-03-06 21:00:00,null,null,6,6,6,5,null,null,null,null,null
20200510,AS,0,83,null,2020-05-10 20:00:00,0,null,83,83,83,60,0,0,0,0,0
20200509,AS,0,83,null,2020-05-09 20:00:00,0,null,83,83,83,60,0,0,0,0,0
20200508,AS,0,83,null,2020-05-08 20:00:00,0,null,83,83,83,60,0,0,0,0,0
20200507,AS,0,83,null,2020-05-07 20:00:00,0,null,83,83,83,60,0,0,0,0,0
20200506,AS,0,83,null,2020-05-06 20:00:00,0,null,83,83,83,60,0,0,0,0,0
20200505,AS,0,83,null,2020-05-05 20:00:00,0,null,83,83,83,60,0,0,0,0,0
20200503,AS,0,57,null,2020-05-03 20:00:00,0,null,57,57,57,60,0,0,0,0,0
20200502,AS,0,57,null,2020-05-02 20:00:00,0,null,57,57,57,60,0,0,0,0,0
20200430,AS,0,3,17,2020-04-30 20:00:00,0,null,20,3,3,60,0,0,0,0,0
20200429,AS,0,3,17,2020-04-29 20:00:00,0,null,20,3,3,60,0,0,0,0,0
20200428,AS,0,3,17,2020-04-28 20:00:00,0,null,20,3,3,60,0,0,0,0,0
20200427,AS,0,3,17,2020-04-27 20:00:00,0,null,20,3,3,60,0,0,0,0,0
20200426,AS,0,3,17,2020-04-26 20:00:00,0,null,20,3,3,60,0,0,0,0,0
20200425,AS,0,3,17,2020-04-25 20:00:00,0,null,20,3,3,60,0,0,0,0,0
20200424,AS,0,3,17,2020-04-24 20:00:00,null,null,20,3,3,60,0,0,0,0,0
20200423,AS,0,3,17,2020-04-23 20:00:00,null,null,20,3,3,60,0,0,0,0,0
20200422,AS,0,3,17,2020-04-22 20:00:00,null,null,20,3,3,60,0,0,0,0,0
20200421,AS,0,3,17,2020-04-21 20:00:00,null,null,20,3,3,60,0,0,0,0,0
20200420,AS,0,3,17,2020-04-20 20:00:00,null,null,20,3,3,60,0,0,0,0,0
20200419,AS,0,3,17,2020-04-19 20:00:00,null,null,20,3,3,60,0,0,0,0,0
20200418,AS,0,3,17,2020-04-18 20:00:00,null,null,20,3,3,60,0,0,0,0,0
20200417,AS,0,3,17,2020-04-17 20:00:00,null,null,20,3,3,60,0,0,0,0,0
20200416,AS,0,3,17,2020-04-16 20:00:00,null,null,20,3,3,60,0,0,0,0,0
20200415,AS,0,3,17,2020-04-15 20:00:00,null,null,20,3,3,60,0,0,0,0,0
20200414,AS,0,3,17,2020-04-14 20:00:00,null,null,20,3,3,60,0,0,0,0,0
20200413,AS,0,3,null,2020-04-13 20:00:00,null,null,3,3,3,60,0,0,0,0,0
20200412,AS,0,3,2,2020-04-12 20:00:00,null,null,5,3,3,60,0,0,0,0,0
20200411,AS,0,3,2,2020-04-11 20:00:00,null,null,5,3,3,60,0,0,0,0,0
20200410,AS,0,3,2,2020-04-10 20:00:00,0,null,5,3,3,60,0,0,0,0,0
20200409,AS,0,3,2,2020-04-09 20:00:00,0,null,5,3,3,60,0,0,0,0,0
20200408,AS,0,3,2,2020-04-08 20:00:00,0,null,5,3,3,60,0,0,0,0,0
20200407,AS,0,3,2,2020-04-07 20:00:00,0,null,5,3,3,60,0,0,0,0,0
20200406,AS,0,3,2,2020-04-06 20:00:00,0,null,5,3,3,60,0,0,0,0,0
20200405,AS,0,3,2,2020-04-05 20:00:00,0,null,5,3,3,60,0,0,0,0,0
20200404,AS,0,3,2,2020-04-04 20:00:00,0,null,5,3,3,60,0,0,0,0,0
20200403,AS,0,3,2,2020-04-03 20:00:00,0,null,5,3,3,60,0,0,0,0,0
20200402,AS,0,3,2,2020-04-02 20:00:00,0,null,5,3,3,60,0,0,0,0,0
20200401,AS,0,3,2,2020-04-01 20:00:00,0,null,5,3,3,60,0,0,0,0,0
20200330,AS,null,null,null,2020-03-30 20:00:00,0,null,0,0,0,60,0,0,0,0,0
20200329,AS,null,null,null,2020-03-29 20:00:00,0,null,0,0,0,60,0,0,0,0,0
20200328,AS,null,null,null,2020-03-28 20:00:00,0,null,0,0,0,60,0,0,0,0,0
20200327,AS,null,null,null,2020-03-27 20:00:00,0,null,0,0,0,60,0,0,0,0,0
20200326,AS,null,null,null,2020-03-26 20:00:00,0,null,0,0,0,60,0,0,0,0,0
20200325,AS,null,null,null,2020-03-25 20:00:00,0,null,0,0,0,60,0,0,0,0,0
20200324,AS,null,null,null,2020-03-24 20:00:00,0,null,0,0,0,60,0,0,0,0,0
20200323,AS,null,null,null,2020-03-23 20:00:00,0,null,0,0,0,60,0,0,0,0,0
20200322,AS,null,null,null,2020-03-22 20:00:00,0,null,0,0,0,60,0,0,0,0,0
20200321,AS,null,null,null,2020-03-21 20:00:00,0,null,0,0,0,60,0,0,0,0,0
20200320,AS,null,null,null,2020-03-20 20:00:00,0,null,0,0,0,60,0,0,0,0,0
20200319,AS,null,null,null,2020-03-19 20:00:00,0,null,0,0,0,60,0,0,0,0,0
20200318,AS,null,null,null,2020-03-18 20:00:00,0,null,0,0,0,60,0,0,0,0,0
20200317,AS,null,null,null,2020-03-17 20:00:00,null,null,0,0,0,60,0,0,0,0,0
20200331,AS,0,3,2,2020-03-31 20:00:00,0,null,5,3,3,60,0,0,3,0,3
20200511,AS,0,105,null,2020-05-11 20:00:00,0,null,105,105,105,60,0,0,22,0,22
20200504,AS,0,83,null,2020-05-04 20:00:00,0,null,83,83,83,60,0,0,26,0,26
20200501,AS,0,57,null,2020-05-01 20:00:00,0,null,57,57,57,60,0,0,54,0,54
20200316,AS,null,null,null,2020-03-16 20:00:00,null,null,0,0,0,60,null,null,null,null,null
20200315,AZ,12,121,50,2020-03-15 20:00:00,0,null,183,133,133,4,0,0,0,0,0
20200309,AZ,5,44,7,2020-03-09 20:00:00,null,null,56,49,49,4,0,0,0,0,0
20200308,AZ,5,44,7,2020-03-08 20:00:00,null,null,56,49,49,4,0,0,0,0,0
20200305,AZ,2,28,6,2020-03-05 21:00:00,null,null,36,30,30,4,0,0,1,0,1
20200306,AZ,3,33,15,2020-03-06 21:00:00,null,null,51,36,36,4,0,0,5,1,6
20200310,AZ,6,51,27,2020-03-10 20:00:00,null,null,84,57,57,4,0,0,7,1,8
20200316,AZ,18,125,63,2020-03-16 20:00:00,0,null,206,143,143,4,0,0,4,6,10
20200311,AZ,9,59,32,2020-03-11 20:00:00,null,null,100,68,68,4,0,0,8,3,11
20200313,AZ,9,94,40,2020-03-13 20:00:00,0,null,143,103,103,4,0,0,12,0,12
20200307,AZ,5,44,7,2020-03-07 21:00:00,null,null,56,49,49,4,0,0,11,2,13
20200318,AZ,28,148,102,2020-03-18 20:00:00,0,null,278,176,176,4,0,0,6,8,14
20200317,AZ,20,142,66,2020-03-17 20:00:00,0,null,228,162,162,4,0,0,17,2,19
20200312,AZ,9,82,24,2020-03-12 20:00:00,null,null,115,91,91,4,0,0,23,0,23
20200314,AZ,12,121,50,2020-03-14 20:00:00,0,null,183,133,133,4,0,0,27,3,30
20200319,AZ,44,175,130,2020-03-19 20:00:00,0,null,349,219,219,4,0,0,27,16,43
20200320,AZ,65,211,101,2020-03-20 20:00:00,0,null,377,276,276,4,0,0,36,21,57
20200321,AZ,104,240,122,2020-03-21 20:00:00,1,null,466,344,344,4,1,0,29,39,68
20200322,AZ,152,282,87,2020-03-22 20:00:00,2,null,521,434,434,4,1,0,42,48,90
20200324,AZ,357,313,22,2020-03-24 20:00:00,5,null,692,670,670,4,3,0,4,92,96
20200325,AZ,450,323,53,2020-03-25 20:00:00,6,null,826,773,773,4,1,0,10,93,103
20200328,AZ,873,7455,21,2020-03-28 20:00:00,15,null,8349,8328,8328,4,2,0,0,137,137
20200323,AZ,265,309,6,2020-03-23 20:00:00,2,null,580,574,574,4,0,0,27,113,140
20200326,AZ,577,347,33,2020-03-26 20:00:00,8,null,957,924,924,4,2,0,24,127,151
20200405,AZ,2269,25141,null,2020-04-05 20:00:00,64,null,27410,27410,27410,4,12,0,0,250,250
20200410,AZ,3112,34622,null,2020-04-10 20:00:00,97,null,37734,37734,37734,4,8,0,462,94,556
20200421,AZ,5251,49901,null,2020-04-21 20:00:00,208,null,55152,55152,55152,4,21,0,465,187,652
20200414,AZ,3806,40290,null,2020-04-14 20:00:00,131,null,44096,44096,44096,4,9,0,645,104,749
20200407,AZ,2575,30800,null,2020-04-07 20:00:00,73,null,33375,33375,33375,4,8,0,722,119,841
20200428,AZ,6948,60490,null,2020-04-28 20:00:00,293,1095,67438,67438,67438,4,18,44,663,232,895
20200408,AZ,2726,31838,null,2020-04-08 20:00:00,80,null,34564,34564,34564,4,7,0,1038,151,1189
20200415,AZ,3962,41348,null,2020-04-15 20:00:00,142,null,45310,45310,45310,4,11,0,1058,156,1214
20200413,AZ,3702,39645,null,2020-04-13 20:00:00,122,null,43347,43347,43347,4,7,0,1075,163,1238
20200429,AZ,7202,61611,null,2020-04-29 20:00:00,304,1131,68813,68813,68813,4,11,36,1121,254,1375
20200422,AZ,5459,51142,null,2020-04-22 20:00:00,229,null,56601,56601,56601,4,21,0,1241,208,1449
20200420,AZ,5064,49436,null,2020-04-20 20:00:00,187,null,54500,54500,54500,4,3,0,1375,135,1510
20200412,AZ,3539,38570,null,2020-04-12 20:00:00,115,null,42109,42109,42109,4,7,0,1433,146,1579
20200402,AZ,1598,21111,null,2020-04-02 20:00:00,32,null,22709,22709,22709,4,3,0,1466,185,1651
20200401,AZ,1413,19645,null,2020-04-01 20:00:00,29,null,21058,21058,21058,4,5,0,1563,124,1687
20200427,AZ,6716,59827,null,2020-04-27 20:00:00,275,1051,66543,66543,66543,4,0,14,1542,190,1732
20200425,AZ,6280,56228,null,2020-04-25 20:00:00,266,1022,62508,62508,62508,4,0,38,1559,235,1794
20200418,AZ,4719,46326,null,2020-04-18 20:00:00,177,null,51045,51045,51045,4,8,0,1603,212,1815
20200417,AZ,4507,44723,null,2020-04-17 20:00:00,169,null,49230,49230,49230,4,19,0,1559,273,1832
20200419,AZ,4929,48061,null,2020-04-19 20:00:00,184,null,52990,52990,52990,4,7,0,1735,210,1945
20200403,AZ,1769,22904,null,2020-04-03 20:00:00,41,null,24673,24673,24673,4,9,0,1793,171,1964
20200424,AZ,6045,54669,null,2020-04-24 20:00:00,266,984,60714,60714,60714,4,17,984,1741,276,2017
20200416,AZ,4234,43164,null,2020-04-16 20:00:00,150,null,47398,47398,47398,4,8,0,1816,272,2088
20200423,AZ,5769,52928,null,2020-04-23 20:00:00,249,null,58697,58697,58697,4,20,0,1786,310,2096
20200426,AZ,6526,58285,null,2020-04-26 20:00:00,275,1037,64811,64811,64811,4,9,15,2057,246,2303
20200404,AZ,2019,25141,null,2020-04-04 20:00:00,52,null,27160,27160,27160,4,11,0,2237,250,2487
20200331,AZ,1289,18082,null,2020-03-31 20:00:00,24,null,19371,19371,19371,4,4,0,2480,132,2612
20200409,AZ,3018,34160,null,2020-04-09 20:00:00,89,null,37178,37178,37178,4,9,0,2322,292,2614
20200411,AZ,3393,37137,null,2020-04-11 20:00:00,108,null,40530,40530,40530,4,11,0,2515,281,2796
20200330,AZ,1157,15602,null,2020-03-30 20:00:00,20,null,16759,16759,16759,4,3,0,2649,238,2887
20200430,AZ,7648,64138,null,2020-04-30 20:00:00,320,1169,71786,71786,71786,4,16,38,2527,446,2973
20200505,AZ,9305,78955,null,2020-05-05 20:00:00,395,1397,88260,88260,88260,4,33,40,2621,386,3007
20200501,AZ,7962,66917,null,2020-05-01 20:00:00,330,1203,74879,74879,74879,4,10,34,2779,314,3093
20200502,AZ,8364,69633,null,2020-05-02 20:00:00,348,1339,77997,77997,77997,4,18,136,2716,402,3118
20200503,AZ,8640,72479,null,2020-05-03 20:00:00,362,1348,81119,81119,81119,4,14,9,2846,276,3122
20200506,AZ,9707,82030,null,2020-05-06 20:00:00,426,1430,91737,91737,91737,4,31,33,3075,402,3477
20200504,AZ,8919,76334,null,2020-05-04 20:00:00,362,1357,85253,85253,85253,4,0,9,3855,279,4134
20200406,AZ,2456,30078,null,2020-04-06 20:00:00,65,null,32534,32534,32534,4,1,0,4937,187,5124
20200329,AZ,919,12953,null,2020-03-29 20:00:00,17,null,13872,13872,13872,4,2,0,5498,46,5544
20200327,AZ,736,7455,30,2020-03-27 20:00:00,13,null,8221,8191,8191,4,5,0,7108,159,7267
20200510,AZ,11119,126620,null,2020-05-10 20:00:00,536,1528,137739,137739,137739,4,4,14,8640,159,8799
20200508,AZ,10526,109381,null,2020-05-08 20:00:00,517,1482,119907,119907,119907,4,67,33,8240,581,8821
20200509,AZ,10960,117980,null,2020-05-09 20:00:00,532,1514,128940,128940,128940,4,15,32,8599,434,9033
20200511,AZ,11380,138861,null,2020-05-11 20:00:00,542,1537,150241,150241,150241,4,6,9,12241,261,12502
20200507,AZ,9945,101141,null,2020-05-07 20:00:00,450,1449,111086,111086,111086,4,24,19,19111,238,19349
20200304,AZ,2,27,5,2020-03-04 21:00:00,null,null,34,29,29,4,null,null,null,null,null
20200313,CA,202,916,null,2020-03-13 20:00:00,4,null,1118,1118,1118,6,0,0,0,0,0
20200305,CA,53,462,null,2020-03-05 21:00:00,null,null,515,515,515,6,0,0,0,0,0
20200306,CA,60,462,null,2020-03-06 21:00:00,null,null,522,522,522,6,0,0,0,7,7
20200307,CA,69,462,null,2020-03-07 21:00:00,null,null,531,531,531,6,0,0,0,9,9
20200310,CA,133,690,null,2020-03-10 20:00:00,null,null,823,823,823,6,0,0,0,19,19
20200308,CA,88,462,null,2020-03-08 20:00:00,null,null,550,550,550,6,0,0,0,19,19
20200315,CA,293,916,null,2020-03-15 20:00:00,5,null,1209,1209,1209,6,0,0,0,41,41
20200312,CA,202,916,null,2020-03-12 20:00:00,4,null,1118,1118,1118,6,4,0,0,45,45
20200314,CA,252,916,null,2020-03-14 20:00:00,5,null,1168,1168,1168,6,1,0,0,50,50
20200318,CA,611,7981,null,2020-03-18 20:00:00,13,null,8592,8592,8592,6,2,0,0,128,128
20200317,CA,483,7981,null,2020-03-17 20:00:00,11,null,8464,8464,8464,6,5,0,0,148,148
20200311,CA,157,916,null,2020-03-11 20:00:00,null,null,1073,1073,1073,6,0,0,226,24,250
20200309,CA,114,690,null,2020-03-09 20:00:00,null,null,804,804,804,6,0,0,228,26,254
20200322,CA,1536,11304,null,2020-03-22 20:00:00,27,null,12840,12840,12840,6,3,0,55,257,312
20200413,CA,22348,168534,13200,2020-04-13 20:00:00,687,null,204082,190882,190882,6,36,0,0,554,554
20200401,CA,8155,21772,57400,2020-04-01 20:00:00,171,null,87327,29927,29927,6,18,0,0,673,673
20200330,CA,6447,20549,64400,2020-03-30 20:00:00,133,null,91396,26996,26996,6,10,0,0,739,739
20200327,CA,3879,17380,57400,2020-03-27 20:00:00,78,null,78659,21259,21259,6,13,0,0,873,873
20200406,CA,14336,103095,15000,2020-04-06 20:00:00,343,null,132431,117431,117431,6,24,0,0,898,898
20200321,CA,1279,11249,null,2020-03-21 20:00:00,24,null,12528,12528,12528,6,4,0,825,216,1041
20200329,CA,5708,20549,64400,2020-03-29 20:00:00,123,null,90657,26257,26257,6,22,0,0,1065,1065
20200319,CA,924,8787,null,2020-03-19 20:00:00,18,null,9711,9711,9711,6,5,0,806,313,1119
20200324,CA,2102,13452,12100,2020-03-24 20:00:00,40,null,27654,15554,15554,6,13,0,885,369,1254
20200410,CA,19472,145391,13900,2020-04-10 20:00:00,541,null,178763,164863,164863,6,49,0,200,1163,1363
20200323,CA,1733,12567,12100,2020-03-23 20:00:00,27,null,26400,14300,14300,6,0,0,1263,197,1460
20200320,CA,1063,10424,null,2020-03-20 20:00:00,20,null,11487,11487,11487,6,2,0,1637,139,1776
20200326,CA,3006,17380,57400,2020-03-26 20:00:00,65,null,77786,20386,20386,6,12,0,1459,651,2110
20200331,CA,7482,21772,57400,2020-03-31 20:00:00,153,null,86654,29254,29254,6,20,0,1223,1035,2258
20200403,CA,10701,24599,59500,2020-04-03 20:00:00,237,null,94800,35300,35300,6,34,0,790,1510,2300
20200325,CA,2355,15921,48600,2020-03-25 20:00:00,53,null,66876,18276,18276,6,13,0,2469,253,2722
20200405,CA,13438,103095,15000,2020-04-05 20:00:00,319,null,131533,116533,116533,6,43,0,1421,1412,2833
20200402,CA,9191,23809,59500,2020-04-02 20:00:00,203,null,92500,33000,33000,6,32,0,2037,1036,3073
20200328,CA,4643,20549,64400,2020-03-28 20:00:00,101,null,89592,25192,25192,6,23,0,3169,764,3933
20200417,CA,27528,224086,7200,2020-04-17 20:00:00,985,null,258814,251614,251614,6,95,0,3868,1346,5214
20200316,CA,335,7981,null,2020-03-16 20:00:00,6,null,8316,8316,8316,6,1,0,7065,42,7107
20200418,CA,28963,230703,7200,2020-04-18 20:00:00,1072,null,266866,259666,259666,6,87,0,6617,1435,8052
20200411,CA,20615,152604,13200,2020-04-11 20:00:00,609,null,186419,173219,173219,6,68,0,7213,1143,8356
20200421,CA,33261,266839,null,2020-04-21 20:00:00,1268,null,300100,300100,300100,6,60,0,7317,2283,9600
20200420,CA,30978,259522,null,2020-04-20 20:00:00,1208,null,290500,290500,290500,6,42,0,8955,645,9600
20200414,CA,23338,178870,13200,2020-04-14 20:00:00,758,null,215408,202208,202208,6,71,0,10336,990,11326
20200425,CA,41137,464898,null,2020-04-25 20:00:00,1651,null,506035,506035,506035,6,89,0,9979,1883,11862
20200424,CA,39254,454919,null,2020-04-24 20:00:00,1562,null,494173,494173,494173,6,93,0,10191,1885,12076
20200408,CA,16957,127307,14600,2020-04-08 20:00:00,442,null,158864,144264,144264,6,68,0,11943,1092,13035
20200407,CA,15865,115364,14100,2020-04-07 20:00:00,374,null,145329,131229,131229,6,31,0,12269,1529,13798
20200415,CA,24424,192062,13200,2020-04-15 20:00:00,821,null,229686,216486,216486,6,63,0,13192,1086,14278
20200423,CA,37369,444728,null,2020-04-23 20:00:00,1469,null,482097,482097,482097,6,115,0,14797,1973,16770
20200412,CA,21794,168534,13200,2020-04-12 20:00:00,651,null,203528,190328,190328,6,42,0,15930,1179,17109
20200409,CA,18309,145191,14100,2020-04-09 20:00:00,492,null,177600,163500,163500,6,50,0,17884,1352,19236
20200426,CA,42164,483920,null,2020-04-26 20:00:00,1710,null,526084,526084,526084,6,59,0,19022,1027,20049
20200419,CA,30333,250567,7200,2020-04-19 20:00:00,1166,null,288100,280900,280900,6,94,0,19864,1370,21234
20200430,CA,48917,576420,null,2020-04-30 20:00:00,1982,null,625337,625337,625337,6,95,0,19781,2417,22198
20200428,CA,45031,532577,null,2020-04-28 20:00:00,1809,null,577608,577608,577608,6,54,0,22632,1567,24199
20200429,CA,46500,556639,null,2020-04-29 20:00:00,1887,null,603139,603139,603139,6,78,0,24062,1469,25531
20200427,CA,43464,509945,null,2020-04-27 20:00:00,1755,null,553409,553409,553409,6,45,0,26025,1300,27325
20200503,CA,53616,662135,null,2020-05-03 20:00:00,2215,null,715751,715751,715751,6,44,0,27529,1419,28948
20200506,CA,58815,750221,null,2020-05-06 20:00:00,2412,null,809036,809036,809036,6,95,0,26531,2603,29134
20200501,CA,50442,604543,null,2020-05-01 20:00:00,2073,null,654985,654985,654985,6,91,0,28123,1525,29648
20200416,CA,26182,220218,13200,2020-04-16 20:00:00,890,null,259600,246400,246400,6,69,0,28156,1758,29914
20200502,CA,52197,634606,null,2020-05-02 20:00:00,2171,null,686803,686803,686803,6,98,0,30063,1755,31818
20200505,CA,56212,723690,null,2020-05-05 20:00:00,2317,null,779902,779902,779902,6,63,0,30753,1275,32028
20200504,CA,54937,692937,null,2020-05-04 20:00:00,2254,null,747874,747874,747874,6,39,0,30802,1321,32123
20200508,CA,62512,812760,null,2020-05-08 20:00:00,2585,null,875272,875272,875272,6,81,0,30500,1898,32398
20200507,CA,60614,782260,null,2020-05-07 20:00:00,2504,null,842874,842874,842874,6,92,0,32039,1799,33838
20200511,CA,67939,923958,null,2020-05-11 20:00:00,2770,null,991897,991897,991897,6,25,0,34974,1259,36233
20200509,CA,64561,848009,null,2020-05-09 20:00:00,2678,null,912570,912570,912570,6,93,0,35249,2049,37298
20200510,CA,66680,888984,null,2020-05-10 20:00:00,2745,null,955664,955664,955664,6,67,0,40975,2119,43094
20200404,CA,12026,101674,13000,2020-04-04 20:00:00,276,null,126700,113700,113700,6,39,0,77075,1325,78400
20200422,CA,35396,429931,null,2020-04-22 20:00:00,1354,null,465327,465327,465327,6,86,0,163092,2135,165227
20200304,CA,53,462,null,2020-03-04 21:00:00,null,null,515,515,515,6,null,null,null,null,null
20200411,CO,6510,26143,null,2020-04-11 20:00:00,250,1312,32653,32653,32653,8,0,0,0,0,0
20200331,CO,2627,12737,null,2020-03-31 20:00:00,51,414,15364,15364,15364,8,0,0,0,0,0
20200316,CO,131,627,null,2020-03-16 20:00:00,1,null,758,758,758,8,0,0,0,0,0
20200310,CO,12,142,1,2020-03-10 20:00:00,null,null,155,154,154,8,0,0,9,3,12
20200307,CO,8,55,69,2020-03-07 21:00:00,null,null,132,63,63,8,0,0,9,6,15
20200306,CO,2,46,30,2020-03-06 21:00:00,null,null,78,48,48,8,0,0,27,2,29
20200309,CO,9,133,null,2020-03-09 20:00:00,null,null,142,142,142,8,0,0,29,1,30
20200315,CO,131,627,null,2020-03-15 20:00:00,1,null,758,758,758,8,0,0,17,30,47
20200308,CO,8,104,null,2020-03-08 20:00:00,null,null,112,112,112,8,0,0,49,0,49
20200312,CO,45,298,null,2020-03-12 20:00:00,null,null,343,343,343,8,0,0,47,17,64
20200314,CO,101,610,null,2020-03-14 20:00:00,1,null,711,711,711,8,1,0,86,29,115
20200311,CO,28,251,null,2020-03-11 20:00:00,null,null,279,279,279,8,0,0,109,16,125
20200313,CO,72,524,null,2020-03-13 20:00:00,null,null,596,596,596,8,0,0,226,27,253
20200326,CO,1086,6978,null,2020-03-26 20:00:00,19,148,8064,8064,8064,8,8,64,189,174,363
20200317,CO,160,1056,null,2020-03-17 20:00:00,1,null,1216,1216,1216,8,0,0,429,29,458
20200319,CO,216,2112,null,2020-03-19 20:00:00,2,null,2328,2328,2328,8,0,0,495,33,528
20200318,CO,183,1617,null,2020-03-18 20:00:00,2,null,1800,1800,1800,8,1,0,561,23,584
20200320,CO,277,2675,null,2020-03-20 20:00:00,3,null,2952,2952,2952,8,1,0,563,61,624
20200321,CO,363,3317,null,2020-03-21 20:00:00,4,44,3680,3680,3680,8,1,44,642,86,728
20200324,CO,720,5504,null,2020-03-24 20:00:00,7,72,6224,6224,6224,8,1,14,659,129,788
20200415,CO,7941,31639,null,2020-04-15 20:00:00,329,1556,39580,39580,39580,8,21,63,588,250,838
20200322,CO,475,4075,null,2020-03-22 20:00:00,5,49,4550,4550,4550,8,1,5,758,112,870
20200323,CO,591,4845,null,2020-03-23 20:00:00,6,58,5436,5436,5436,8,1,9,770,116,886
20200416,CO,8280,32253,null,2020-04-16 20:00:00,357,1636,40533,40533,40533,8,28,80,614,339,953
20200506,CO,17364,68612,null,2020-05-06 20:00:00,903,2919,85976,85976,85976,8,52,81,515,457,972
20200407,CO,5172,21703,null,2020-04-07 20:00:00,150,994,26875,26875,26875,8,10,70,880,222,1102
20200409,CO,5655,23544,null,2020-04-09 20:00:00,193,1162,29199,29199,29199,8,14,83,879,226,1105
20200414,CO,7691,31051,null,2020-04-14 20:00:00,308,1493,38742,38742,38742,8,4,21,1201,7,1208
20200408,CO,5429,22665,null,2020-04-08 20:00:00,179,1079,28094,28094,28094,8,29,85,962,257,1219
20200422,CO,10447,38257,null,2020-04-22 20:00:00,486,2003,48704,48704,48704,8,37,123,897,341,1238
20200421,CO,10106,37360,null,2020-04-21 20:00:00,449,1880,47466,47466,47466,8,27,67,895,376,1271
20200417,CO,8675,33155,null,2020-04-17 20:00:00,374,1693,41830,41830,41830,8,17,57,902,395,1297
20200419,CO,9433,35173,null,2020-04-19 20:00:00,411,1797,44606,44606,44606,8,20,42,913,386,1299
20200501,CO,15284,57106,null,2020-05-01 20:00:00,777,2697,72390,72390,72390,8,11,76,805,526,1331
20200418,CO,9047,34260,null,2020-04-18 20:00:00,391,1755,43307,43307,43307,8,17,62,1105,372,1477
20200325,CO,912,6789,null,2020-03-25 20:00:00,11,84,7701,7701,7701,8,4,12,1285,192,1477
20200401,CO,2966,13883,null,2020-04-01 20:00:00,69,509,16849,16849,16849,8,18,95,1146,339,1485
20200328,CO,1734,9942,null,2020-03-28 20:00:00,31,239,11676,11676,11676,8,7,55,1250,304,1554
20200420,CO,9730,36465,null,2020-04-20 20:00:00,422,1813,46195,46195,46195,8,11,16,1292,297,1589
20200329,CO,2061,11215,null,2020-03-29 20:00:00,44,274,13276,13276,13276,8,13,35,1273,327,1600
20200430,CO,14758,56301,null,2020-04-30 20:00:00,766,2621,71059,71059,71059,8,6,11,1587,23,1610
20200404,CO,4173,17898,null,2020-04-04 20:00:00,111,823,22071,22071,22071,8,14,113,1215,445,1660
20200424,CO,11262,41062,null,2020-04-24 20:00:00,552,2237,52324,52324,52324,8,44,114,1295,384,1679
20200403,CO,3728,16683,null,2020-04-03 20:00:00,97,710,20411,20411,20411,8,17,90,1380,386,1766
20200402,CO,3342,15303,null,2020-04-02 20:00:00,80,620,18645,18645,18645,8,11,111,1420,376,1796
20200405,CO,4565,19335,null,2020-04-05 20:00:00,126,875,23900,23900,23900,8,15,52,1437,392,1829
20200406,CO,4950,20823,null,2020-04-06 20:00:00,140,924,25773,25773,25773,8,14,49,1488,385,1873
20200505,CO,16907,68097,null,2020-05-05 20:00:00,851,2838,85004,85004,85004,8,9,39,1642,272,1914
20200423,CO,10878,39767,null,2020-04-23 20:00:00,508,2123,50645,50645,50645,8,22,120,1510,431,1941
20200327,CO,1430,8692,null,2020-03-27 20:00:00,24,184,10122,10122,10122,8,5,36,1714,344,2058
20200330,CO,2627,12737,null,2020-03-30 20:00:00,51,414,15364,15364,15364,8,7,140,1522,566,2088
20200412,CO,6893,27980,null,2020-04-12 20:00:00,274,1376,34873,34873,34873,8,24,64,1837,383,2220
20200509,CO,18827,77945,null,2020-05-09 20:00:00,960,3600,96772,96772,96772,8,-1,43,2210,26,2236
20200413,CO,7684,29850,null,2020-04-13 20:00:00,304,1472,37534,37534,37534,8,30,96,1870,791,2661
20200503,CO,16225,63681,null,2020-05-03 20:00:00,832,2793,79906,79906,79906,8,12,46,2500,457,2957
20200426,CO,12968,46823,null,2020-04-26 20:00:00,672,2410,59791,59791,59791,8,-2,44,2290,712,3002
20200428,CO,13879,52462,null,2020-04-28 20:00:00,706,2485,66341,66341,66341,8,26,47,2629,438,3067
20200429,CO,14735,54714,null,2020-04-29 20:00:00,760,2610,69449,69449,69449,8,54,125,2252,856,3108
20200504,CO,16635,66455,null,2020-05-04 20:00:00,842,2799,83090,83090,83090,8,10,6,2774,410,3184
20200508,CO,18801,75735,null,2020-05-08 20:00:00,961,3557,94536,94536,94536,8,40,571,2218,971,3189
20200410,CO,6510,26143,null,2020-04-10 20:00:00,250,1312,32653,32653,32653,8,57,150,2599,855,3454
20200427,CO,13441,49833,null,2020-04-27 20:00:00,680,2438,63274,63274,63274,8,8,28,3010,473,3483
20200510,CO,19375,81235,null,2020-05-10 20:00:00,967,3623,100610,100610,100610,8,7,23,3290,548,3838
20200425,CO,12256,44533,null,2020-04-25 20:00:00,674,2366,56789,56789,56789,8,122,129,3471,994,4465
20200502,CO,15768,61181,null,2020-05-02 20:00:00,820,2747,76949,76949,76949,8,43,50,4075,484,4559
20200507,CO,17830,73517,null,2020-05-07 20:00:00,921,2986,91347,91347,91347,8,18,67,4905,466,5371
20200511,CO,19899,88891,null,2020-05-11 20:00:00,981,3689,108790,108790,108790,8,14,66,7656,524,8180
20200305,CO,0,19,21,2020-03-05 21:00:00,null,null,40,19,19,8,null,null,null,null,null
20200504,CT,29287,73206,null,2020-05-04 20:00:00,2495,7758,102493,102493,102493,9,59,0,0,0,0
20200502,CT,28764,71493,null,2020-05-02 20:00:00,2339,7758,100257,100257,100257,9,0,0,0,0,0
20200427,CT,25269,54542,null,2020-04-27 20:00:00,1998,null,79811,79811,79811,9,74,0,0,0,0
20200418,CT,16809,38653,null,2020-04-18 20:00:00,1036,null,55462,55462,55462,9,0,0,0,0,0
20200408,CT,7781,21255,null,2020-04-08 20:00:00,277,null,29036,29036,29036,9,0,0,0,0,0
20200328,CT,1291,7109,null,2020-03-28 20:00:00,27,null,8400,8400,8400,9,0,0,0,0,0
20200316,CT,26,125,null,2020-03-16 20:00:00,null,null,151,151,151,9,0,0,0,6,6
20200315,CT,20,125,null,2020-03-15 20:00:00,null,null,145,145,145,9,0,0,0,9,9
20200310,CT,2,54,null,2020-03-10 20:00:00,null,null,56,56,56,9,0,0,8,1,9
20200313,CT,6,99,null,2020-03-13 20:00:00,null,null,105,105,105,9,0,0,10,0,10
20200317,CT,41,125,null,2020-03-17 20:00:00,null,null,166,166,166,9,0,0,0,15,15
20200309,CT,1,46,null,2020-03-09 20:00:00,null,null,47,47,47,9,0,0,17,0,17
20200311,CT,3,71,null,2020-03-11 20:00:00,null,null,74,74,74,9,0,0,17,1,18
20200312,CT,6,89,null,2020-03-12 20:00:00,null,null,95,95,95,9,0,0,18,3,21
20200318,CT,68,125,null,2020-03-18 20:00:00,null,null,193,193,193,9,0,0,0,27,27
20200308,CT,1,29,8,2020-03-08 20:00:00,null,null,38,30,30,9,0,0,29,1,30
20200314,CT,11,125,null,2020-03-14 20:00:00,null,null,136,136,136,9,0,0,26,5,31
20200320,CT,194,604,null,2020-03-20 20:00:00,3,null,798,798,798,9,2,0,0,98,98
20200401,CT,3557,13043,null,2020-04-01 20:00:00,85,null,16600,16600,16600,9,16,0,14,429,443
20200319,CT,96,604,null,2020-03-19 20:00:00,1,null,700,700,700,9,1,0,479,28,507
20200325,CT,875,5023,null,2020-03-25 20:00:00,19,null,5898,5898,5898,9,7,0,341,257,598
20200326,CT,1012,5625,null,2020-03-26 20:00:00,21,null,6637,6637,6637,9,2,0,602,137,739
20200324,CT,618,4682,null,2020-03-24 20:00:00,12,null,5300,5300,5300,9,2,0,597,203,800
20200322,CT,223,2877,null,2020-03-22 20:00:00,5,null,3100,3100,3100,9,1,0,771,29,800
20200405,CT,5675,17595,null,2020-04-05 20:00:00,189,null,23270,23270,23270,9,24,0,842,399,1241
20200421,CT,20360,43832,null,2020-04-21 20:00:00,1423,null,64192,64192,64192,9,92,0,841,545,1386
20200412,CT,12035,29185,null,2020-04-12 20:00:00,554,null,41220,41220,41220,9,60,0,864,525,1389
20200323,CT,415,4085,null,2020-03-23 20:00:00,10,null,4500,4500,4500,9,5,0,1208,192,1400
20200321,CT,194,2106,null,2020-03-21 20:00:00,4,null,2300,2300,2300,9,1,0,1502,0,1502
20200414,CT,13989,31852,null,2020-04-14 20:00:00,671,null,45841,45841,45841,9,69,0,924,608,1532
20200331,CT,3128,13029,null,2020-03-31 20:00:00,69,null,16157,16157,16157,9,33,0,1000,557,1557
20200423,CT,23100,48397,null,2020-04-23 20:00:00,1639,null,71497,71497,71497,9,95,0,948,631,1579
20200402,CT,3824,14476,null,2020-04-02 20:00:00,112,null,18300,18300,18300,9,27,0,1433,267,1700
20200403,CT,4914,15101,null,2020-04-03 20:00:00,131,null,20015,20015,20015,9,19,0,625,1090,1715
20200327,CT,1291,7109,null,2020-03-27 20:00:00,27,null,8400,8400,8400,9,6,0,1484,279,1763
20200404,CT,5276,16753,null,2020-04-04 20:00:00,165,null,22029,22029,22029,9,34,0,1652,362,2014
20200429,CT,26767,68051,null,2020-04-29 20:00:00,2168,null,94818,94818,94818,9,79,0,1618,455,2073
20200426,CT,25269,54542,null,2020-04-26 20:00:00,1924,null,79811,79811,79811,9,62,0,1522,687,2209
20200503,CT,29287,73206,null,2020-05-03 20:00:00,2436,7758,102493,102493,102493,9,97,0,1713,523,2236
20200430,CT,27700,69433,null,2020-04-30 20:00:00,2257,null,97133,97133,97133,9,89,0,1382,933,2315
20200511,CT,33765,98743,null,2020-05-11 20:00:00,3008,9389,132508,132508,132508,9,41,0,2105,211,2316
20200417,CT,16809,38653,null,2020-04-17 20:00:00,1036,null,55462,55462,55462,9,65,0,1415,925,2340
20200407,CT,7781,21255,null,2020-04-07 20:00:00,277,null,29036,29036,29036,9,71,0,1475,875,2350
20200424,CT,23921,50117,null,2020-04-24 20:00:00,1764,null,74038,74038,74038,9,125,0,1720,821,2541
20200330,CT,2571,12029,null,2020-03-30 20:00:00,36,null,14600,14600,14600,9,2,0,2122,578,2700
20200419,CT,17550,40663,null,2020-04-19 20:00:00,1086,null,58213,58213,58213,9,50,0,2010,741,2751
20200410,CT,10538,25750,null,2020-04-10 20:00:00,448,null,36288,36288,36288,9,68,0,2032,754,2786
20200506,CT,30995,80452,null,2020-05-06 20:00:00,2718,7758,111447,111447,111447,9,85,0,2430,374,2804
20200416,CT,15884,37238,null,2020-04-16 20:00:00,971,null,53122,53122,53122,9,103,0,1850,1129,2979
20200509,CT,32984,90585,null,2020-05-09 20:00:00,2932,9389,123569,123569,123569,9,58,0,2455,573,3028
20200413,CT,13381,30928,null,2020-04-13 20:00:00,602,null,44309,44309,44309,9,48,0,1743,1346,3089
20200501,CT,28764,71493,null,2020-05-01 20:00:00,2339,7758,100257,100257,100257,9,82,7758,2060,1064,3124
20200406,CT,6906,19780,null,2020-04-06 20:00:00,206,null,26686,26686,26686,9,17,0,2185,1231,3416
20200329,CT,1993,9907,null,2020-03-29 20:00:00,34,null,11900,11900,11900,9,7,0,2798,702,3500
20200411,CT,11510,28321,null,2020-04-11 20:00:00,494,null,39831,39831,39831,9,46,0,2571,972,3543
20200425,CT,24582,53020,null,2020-04-25 20:00:00,1862,null,77602,77602,77602,9,98,0,2903,661,3564
20200415,CT,14755,35388,null,2020-04-15 20:00:00,868,null,50143,50143,50143,9,197,0,3536,766,4302
20200508,CT,32411,88130,null,2020-05-08 20:00:00,2874,9389,120541,120541,120541,9,77,0,3740,627,4367
20200409,CT,9784,23718,null,2020-04-09 20:00:00,380,null,33502,33502,33502,9,103,0,2463,2003,4466
20200420,CT,19815,42991,null,2020-04-20 20:00:00,1331,null,62806,62806,62806,9,245,0,2328,2265,4593
20200507,CT,31784,84390,null,2020-05-07 20:00:00,2797,9389,116174,116174,116174,9,79,1631,3938,789,4727
20200422,CT,22469,47449,null,2020-04-22 20:00:00,1544,null,69918,69918,69918,9,121,0,3617,2109,5726
20200505,CT,30621,78022,null,2020-05-05 20:00:00,2633,7758,108643,108643,108643,9,138,0,4816,1334,6150
20200510,CT,33554,96638,null,2020-05-10 20:00:00,2967,9389,130192,130192,130192,9,35,0,6053,570,6623
20200428,CT,26312,66433,null,2020-04-28 20:00:00,2089,null,92745,92745,92745,9,91,0,11891,1043,12934
20200307,CT,0,null,null,2020-03-07 21:00:00,null,null,0,0,0,9,null,null,null,null,null
20200313,DC,10,20,null,2020-03-13 20:00:00,null,null,30,30,30,11,0,0,0,0,0
20200307,DC,0,8,1,2020-03-07 21:00:00,null,null,9,8,8,11,0,0,0,0,0
20200306,DC,0,8,1,2020-03-06 21:00:00,null,null,9,8,8,11,0,0,2,0,2
20200311,DC,5,20,15,2020-03-11 20:00:00,null,null,40,25,25,11,0,0,3,0,3
20200308,DC,1,10,0,2020-03-08 20:00:00,null,null,11,11,11,11,0,0,2,1,3
20200309,DC,1,14,3,2020-03-09 20:00:00,null,null,18,15,15,11,0,0,4,0,4
20200312,DC,10,20,null,2020-03-12 20:00:00,null,null,30,30,30,11,0,0,0,5,5
20200310,DC,5,17,2,2020-03-10 20:00:00,null,null,24,22,22,11,0,0,3,4,7
20200321,DC,77,506,0,2020-03-21 20:00:00,1,null,583,583,583,11,0,0,5,6,11
20200317,DC,22,104,0,2020-03-17 20:00:00,null,null,126,126,126,11,0,0,8,5,13
20200316,DC,17,96,7,2020-03-16 20:00:00,null,null,120,113,113,11,0,0,17,1,18
20200319,DC,39,153,11,2020-03-19 20:00:00,0,null,203,192,192,11,0,0,15,8,23
20200314,DC,10,49,10,2020-03-14 20:00:00,null,null,69,59,59,11,0,0,29,0,29
20200315,DC,16,79,20,2020-03-15 20:00:00,null,null,115,95,95,11,0,0,30,6,36
20200318,DC,31,138,1,2020-03-18 20:00:00,null,null,170,169,169,11,0,0,34,9,43
20200401,DC,586,3262,2,2020-04-01 20:00:00,11,null,3850,3848,3848,11,2,0,0,91,91
20200324,DC,137,1195,2,2020-03-24 20:00:00,2,null,1334,1332,1332,11,0,0,82,21,103
20200323,DC,116,1113,null,2020-03-23 20:00:00,2,null,1229,1229,1229,11,1,0,156,18,174
20200415,DC,2197,9328,null,2020-04-15 20:00:00,72,null,11525,11525,11525,11,5,0,102,139,241
20200326,DC,231,1626,1,2020-03-26 20:00:00,3,null,1858,1857,1857,11,1,0,203,48,251
20200330,DC,401,2682,2,2020-03-30 20:00:00,9,null,3085,3083,3083,11,4,0,213,59,272
20200325,DC,183,1423,3,2020-03-25 20:00:00,2,null,1609,1606,1606,11,0,0,228,46,274
20200413,DC,1955,8979,null,2020-04-13 20:00:00,53,null,10934,10934,10934,11,3,0,214,80,294
20200329,DC,342,2469,1,2020-03-29 20:00:00,5,null,2812,2811,2811,11,1,0,258,38,296
20200327,DC,267,1897,2,2020-03-27 20:00:00,3,null,2166,2164,2164,11,0,0,271,36,307
20200429,DC,4106,15123,null,2020-04-29 20:00:00,205,null,19229,19229,19229,11,15,0,232,112,344
20200427,DC,3892,14524,null,2020-04-27 20:00:00,185,null,18416,18416,18416,11,7,0,297,51,348
20200414,DC,2058,9226,null,2020-04-14 20:00:00,67,null,11284,11284,11284,11,14,0,247,103,350
20200328,DC,304,2211,1,2020-03-28 20:00:00,4,null,2516,2515,2515,11,1,0,314,37,351
20200407,DC,1211,6612,null,2020-04-07 20:00:00,22,null,7823,7823,7823,11,-2,0,256,114,370
20200320,DC,71,501,1,2020-03-20 20:00:00,1,null,573,572,572,11,1,0,348,32,380
20200405,DC,998,5836,null,2020-04-05 20:00:00,22,null,6834,6834,6834,11,1,0,300,96,396
20200420,DC,2927,11186,null,2020-04-20 20:00:00,105,null,14113,14113,14113,11,9,0,280,134,414
20200423,DC,3361,12569,null,2020-04-23 20:00:00,139,null,15930,15930,15930,11,12,0,273,155,428
20200419,DC,2793,10906,null,2020-04-19 20:00:00,96,null,13699,13699,13699,11,5,0,304,127,431
20200409,DC,1523,7201,null,2020-04-09 20:00:00,32,null,8724,8724,8724,11,5,0,358,83,441
20200408,DC,1440,6843,null,2020-04-08 20:00:00,27,null,8283,8283,8283,11,5,0,231,229,460
20200428,DC,3994,14891,null,2020-04-28 20:00:00,190,null,18885,18885,18885,11,5,0,367,102,469
20200322,DC,98,957,null,2020-03-22 20:00:00,1,null,1055,1055,1055,11,0,0,451,21,472
20200417,DC,2476,10167,null,2020-04-17 20:00:00,86,null,12643,12643,12643,11,5,0,367,126,493
20200403,DC,757,4827,null,2020-04-03 20:00:00,15,null,5584,5584,5584,11,3,0,410,104,514
20200505,DC,5322,19007,null,2020-05-05 20:00:00,264,null,24329,24329,24329,11,6,0,382,152,534
20200422,DC,3206,12296,null,2020-04-22 20:00:00,127,null,15502,15502,15502,11,15,0,455,108,563
20200412,DC,1875,8765,null,2020-04-12 20:00:00,50,null,10640,10640,10640,11,3,0,504,97,601
20200424,DC,3528,13005,null,2020-04-24 20:00:00,153,null,16533,16533,16533,11,14,0,436,167,603
20200406,DC,1097,6356,null,2020-04-06 20:00:00,24,null,7453,7453,7453,11,2,0,520,99,619
20200418,DC,2666,10602,null,2020-04-18 20:00:00,91,null,13268,13268,13268,11,5,0,435,190,625
20200416,DC,2350,9800,null,2020-04-16 20:00:00,81,null,12150,12150,12150,11,9,0,472,153,625
20200410,DC,1660,7695,null,2020-04-10 20:00:00,38,null,9355,9355,9355,11,6,0,494,137,631
20200506,DC,5461,19523,null,2020-05-06 20:00:00,277,null,24984,24984,24984,11,13,0,516,139,655
20200331,DC,495,3262,2,2020-03-31 20:00:00,9,null,3759,3757,3757,11,0,0,580,94,674
20200411,DC,1778,8261,null,2020-04-11 20:00:00,47,null,10039,10039,10039,11,9,0,566,118,684
20200511,DC,6389,23872,null,2020-05-11 20:00:00,328,null,30261,30261,30261,11,5,0,574,117,691
20200504,DC,5170,18625,null,2020-05-04 20:00:00,258,null,23795,23795,23795,11,7,0,539,154,693
20200426,DC,3841,14227,null,2020-04-26 20:00:00,178,null,18068,18068,18068,11,13,0,624,142,766
20200425,DC,3699,13603,null,2020-04-25 20:00:00,165,null,17302,17302,17302,11,12,0,598,171,769
20200421,DC,3098,11841,null,2020-04-21 20:00:00,112,null,14939,14939,14939,11,7,0,655,171,826
20200430,DC,4323,15756,null,2020-04-30 20:00:00,224,null,20079,20079,20079,11,19,0,633,217,850
20200404,DC,902,5536,null,2020-04-04 20:00:00,21,null,6438,6438,6438,11,6,0,709,145,854
20200502,DC,4797,17207,null,2020-05-02 20:00:00,240,null,22004,22004,22004,11,9,0,730,139,869
20200507,DC,5654,20202,null,2020-05-07 20:00:00,285,null,25856,25856,25856,11,8,0,679,193,872
20200501,DC,4658,16477,null,2020-05-01 20:00:00,231,null,21135,21135,21135,11,7,0,721,335,1056
20200509,DC,6102,22081,null,2020-05-09 20:00:00,311,null,28183,28183,28183,11,7,0,865,203,1068
20200503,DC,5016,18086,null,2020-05-03 20:00:00,251,null,23102,23102,23102,11,11,0,879,219,1098
20200402,DC,653,4417,null,2020-04-02 20:00:00,12,null,5070,5070,5070,11,1,0,1155,67,1222
20200508,DC,5899,21216,null,2020-05-08 20:00:00,304,null,27115,27115,27115,11,19,0,1014,245,1259
20200510,DC,6272,23298,null,2020-05-10 20:00:00,323,null,29570,29570,29570,11,12,0,1217,170,1387
20200305,DC,0,6,2,2020-03-05 21:00:00,null,null,8,6,6,11,null,null,null,null,null
20200411,DE,1479,9624,null,2020-04-11 20:00:00,33,null,11103,11103,11103,10,10,0,-791,153,-638
20200422,DE,3200,13353,null,2020-04-22 20:00:00,89,null,16553,16553,16553,10,7,0,-372,269,-103
20200418,DE,2323,11694,null,2020-04-18 20:00:00,61,null,14017,14017,14017,10,0,0,0,0,0
20200412,DE,1479,9624,null,2020-04-12 20:00:00,33,null,11103,11103,11103,10,0,0,0,0,0
20200408,DE,928,7628,null,2020-04-08 20:00:00,16,null,8556,8556,8556,10,0,0,0,0,0
20200406,DE,673,6321,null,2020-04-06 20:00:00,14,null,6994,6994,6994,10,0,0,0,0,0
20200315,DE,6,36,32,2020-03-15 20:00:00,null,null,74,42,42,10,0,0,0,0,0
20200308,DE,0,10,0,2020-03-08 20:00:00,null,null,10,10,10,10,0,0,0,0,0
20200307,DE,0,10,0,2020-03-07 21:00:00,null,null,10,10,10,10,0,0,0,0,0
20200311,DE,1,17,2,2020-03-11 20:00:00,null,null,20,18,18,10,0,0,0,1,1
20200316,DE,8,36,32,2020-03-16 20:00:00,null,null,76,44,44,10,0,0,0,2,2
20200310,DE,0,17,3,2020-03-10 20:00:00,null,null,20,17,17,10,0,0,2,0,2
20200319,DE,30,36,null,2020-03-19 20:00:00,0,null,66,66,66,10,0,0,0,5,5
20200309,DE,0,15,3,2020-03-09 20:00:00,null,null,18,15,15,10,0,0,5,0,5
20200321,DE,45,36,null,2020-03-21 20:00:00,0,null,81,81,81,10,0,0,0,7,7
20200313,DE,4,30,10,2020-03-13 20:00:00,null,null,44,34,34,10,0,0,7,0,7
20200320,DE,38,36,null,2020-03-20 20:00:00,0,null,74,74,74,10,0,0,0,8,8
20200317,DE,16,36,null,2020-03-17 20:00:00,null,null,52,52,52,10,0,0,0,8,8
20200314,DE,6,36,32,2020-03-14 20:00:00,null,null,74,42,42,10,0,0,6,2,8
20200318,DE,25,36,null,2020-03-18 20:00:00,null,null,61,61,61,10,0,0,0,9,9
20200312,DE,4,23,14,2020-03-12 20:00:00,null,null,41,27,27,10,0,0,6,3,9
20200322,DE,56,36,null,2020-03-22 20:00:00,0,null,92,92,92,10,0,0,0,11,11
20200323,DE,68,36,null,2020-03-23 20:00:00,0,null,104,104,104,10,0,0,0,12,12
20200326,DE,130,36,null,2020-03-26 20:00:00,1,null,166,166,166,10,1,0,0,15,15
20200329,DE,232,36,null,2020-03-29 20:00:00,6,null,268,268,268,10,3,0,0,18,18
20200324,DE,91,36,null,2020-03-24 20:00:00,0,null,127,127,127,10,0,0,0,23,23
20200325,DE,115,36,null,2020-03-25 20:00:00,0,null,151,151,151,10,0,0,0,24,24
20200327,DE,163,36,null,2020-03-27 20:00:00,2,null,199,199,199,10,1,0,0,33,33
20200328,DE,214,36,null,2020-03-28 20:00:00,3,null,250,250,250,10,1,0,0,51,51
20200421,DE,2931,13725,null,2020-04-21 20:00:00,82,null,16656,16656,16656,10,10,0,0,186,186
20200416,DE,2075,11275,null,2020-04-16 20:00:00,52,null,13350,13350,13350,10,6,0,187,61,248
20200430,DE,4734,17086,null,2020-04-30 20:00:00,152,null,21820,21820,21820,10,8,0,203,79,282
20200425,DE,3576,14122,null,2020-04-25 20:00:00,112,null,17698,17698,17698,10,12,0,185,134,319
20200429,DE,4655,16883,null,2020-04-29 20:00:00,144,null,21538,21538,21538,10,7,0,278,80,358
20200423,DE,3308,13604,null,2020-04-23 20:00:00,92,null,16912,16912,16912,10,3,0,251,108,359
20200427,DE,4162,15454,null,2020-04-27 20:00:00,125,null,19616,19616,19616,10,5,0,239,128,367
20200401,DE,368,4015,null,2020-04-01 20:00:00,11,null,4383,4383,4383,10,1,0,319,49,368
20200504,DE,5288,18822,null,2020-05-04 20:00:00,182,null,24110,24110,24110,10,5,0,293,80,373
20200424,DE,3442,13937,null,2020-04-24 20:00:00,100,null,17379,17379,17379,10,8,0,333,134,467
20200414,DE,1761,10543,null,2020-04-14 20:00:00,41,null,12304,12304,12304,10,6,0,348,136,484
20200403,DE,450,4995,null,2020-04-03 20:00:00,14,null,5445,5445,5445,10,2,0,429,57,486
20200502,DE,5038,18074,null,2020-05-02 20:00:00,168,null,23112,23112,23112,10,9,0,407,120,527
20200405,DE,673,6321,null,2020-04-05 20:00:00,14,null,6994,6994,6994,10,0,0,447,80,527
20200505,DE,5371,19309,null,2020-05-05 20:00:00,187,null,24680,24680,24680,10,5,0,487,83,570
20200402,DE,393,4566,null,2020-04-02 20:00:00,12,null,4959,4959,4959,10,1,0,551,25,576
20200503,DE,5208,18529,null,2020-05-03 20:00:00,177,null,23737,23737,23737,10,9,0,455,170,625
20200417,DE,2323,11694,null,2020-04-17 20:00:00,61,null,14017,14017,14017,10,9,0,419,248,667
20200413,DE,1625,10195,null,2020-04-13 20:00:00,35,null,11820,11820,11820,10,2,0,571,146,717
20200501,DE,4918,17667,null,2020-05-01 20:00:00,159,null,22585,22585,22585,10,7,0,581,184,765
20200419,DE,2538,12256,null,2020-04-19 20:00:00,67,null,14794,14794,14794,10,6,0,562,215,777
20200415,DE,2014,11088,null,2020-04-15 20:00:00,46,null,13102,13102,13102,10,5,0,545,253,798
20200507,DE,5939,21387,null,2020-05-07 20:00:00,202,null,27326,27326,27326,10,9,0,697,161,858
20200511,DE,6565,25363,null,2020-05-11 20:00:00,225,null,31928,31928,31928,10,1,0,771,118,889
20200508,DE,6111,22153,null,2020-05-08 20:00:00,213,null,28264,28264,28264,10,11,0,766,172,938
20200404,DE,593,5874,null,2020-04-04 20:00:00,14,null,6467,6467,6467,10,0,0,879,143,1022
20200509,DE,6277,23019,null,2020-05-09 20:00:00,221,null,29296,29296,29296,10,8,0,866,166,1032
20200409,DE,1207,8683,null,2020-04-09 20:00:00,23,null,9890,9890,9890,10,7,0,1055,279,1334
20200331,DE,319,3696,null,2020-03-31 20:00:00,10,null,4015,4015,4015,10,4,0,1480,55,1535
20200426,DE,4034,15215,null,2020-04-26 20:00:00,120,null,19249,19249,19249,10,8,0,1093,458,1551
20200407,DE,928,7628,null,2020-04-07 20:00:00,16,null,8556,8556,8556,10,2,0,1307,255,1562
20200428,DE,4575,16605,null,2020-04-28 20:00:00,137,null,21180,21180,21180,10,12,0,1151,413,1564
20200420,DE,2745,13725,null,2020-04-20 20:00:00,72,null,16470,16470,16470,10,5,0,1469,207,1676
20200510,DE,6447,24592,null,2020-05-10 20:00:00,224,null,31039,31039,31039,10,3,0,1573,170,1743
20200506,DE,5778,20690,null,2020-05-06 20:00:00,193,null,26468,26468,26468,10,6,0,1381,407,1788
20200410,DE,1326,10415,null,2020-04-10 20:00:00,23,null,11741,11741,11741,10,0,0,1732,119,1851
20200330,DE,264,2216,null,2020-03-30 20:00:00,6,null,2480,2480,2480,10,0,0,2180,32,2212
20200306,DE,0,10,0,2020-03-06 21:00:00,null,null,10,10,10,10,null,null,null,null,null
20200312,FL,32,301,147,2020-03-12 20:00:00,2,null,480,333,333,12,0,0,0,4,4
20200305,FL,9,31,69,2020-03-05 21:00:00,null,null,109,40,40,12,0,0,7,7,14
20200308,FL,17,118,108,2020-03-08 20:00:00,null,null,243,135,135,12,0,0,18,3,21
20200309,FL,18,140,115,2020-03-09 20:00:00,null,null,273,158,158,12,0,0,22,1,23
20200306,FL,9,55,51,2020-03-06 21:00:00,null,null,115,64,64,12,0,0,24,0,24
20200314,FL,77,478,221,2020-03-14 20:00:00,3,null,776,555,555,12,1,0,0,27,27
20200316,FL,141,684,514,2020-03-16 20:00:00,4,null,1339,825,825,12,0,0,6,25,31
20200307,FL,14,100,88,2020-03-07 21:00:00,null,null,202,114,114,12,0,0,45,5,50
20200310,FL,19,222,155,2020-03-10 20:00:00,null,null,396,241,241,12,0,0,82,1,83
20200311,FL,28,301,147,2020-03-11 20:00:00,2,null,476,329,329,12,2,0,79,9,88
20200313,FL,50,478,221,2020-03-13 20:00:00,2,null,749,528,528,12,0,0,177,18,195
20200315,FL,116,678,454,2020-03-15 20:00:00,4,null,1248,794,794,12,1,0,200,39,239
20200317,FL,186,940,872,2020-03-17 20:00:00,6,null,1998,1126,1126,12,2,0,256,45,301
20200319,FL,390,1533,1019,2020-03-19 20:00:00,8,null,2942,1923,1923,12,1,0,308,76,384
20200318,FL,314,1225,954,2020-03-18 20:00:00,7,null,2493,1539,1539,12,1,0,285,128,413
20200320,FL,520,1870,1026,2020-03-20 20:00:00,10,null,3416,2390,2390,12,2,0,337,130,467
20200322,FL,830,7990,963,2020-03-22 20:00:00,13,185,9783,8820,8820,12,1,27,1411,172,1583
20200324,FL,1412,13127,1008,2020-03-24 20:00:00,18,259,15547,14539,14539,12,4,42,2064,241,2305
20200325,FL,1682,15374,1233,2020-03-25 20:00:00,22,316,18289,17056,17056,12,4,57,2247,270,2517
20200323,FL,1171,11063,860,2020-03-23 20:00:00,14,217,13094,12234,12234,12,1,32,3073,341,3414
20200329,FL,4246,39070,null,2020-03-29 20:00:00,56,594,43316,43316,43316,12,2,68,3704,483,4187
20200321,FL,658,6579,1002,2020-03-21 20:00:00,12,158,8239,7237,7237,12,2,158,4709,138,4847
20200327,FL,2765,28186,1517,2020-03-27 20:00:00,34,456,32468,30951,30951,12,6,50,4445,410,4855
20200408,FL,15455,127679,1324,2020-04-08 20:00:00,309,2062,144458,143134,143134,12,13,63,4264,708,4972
20200416,FL,22897,196351,1325,2020-04-16 20:00:00,646,3460,220573,219248,219248,12,37,116,5353,386,5739
20200401,FL,6955,59529,1235,2020-04-01 20:00:00,87,949,67719,66484,66484,12,10,126,5244,617,5861
20200429,FL,33193,340295,1252,2020-04-29 20:00:00,1240,5624,374740,373488,373488,12,86,358,6266,347,6613
20200331,FL,6338,54285,1163,2020-03-31 20:00:00,77,823,61786,60623,60623,12,14,171,6060,865,6925
20200414,FL,21367,181813,1275,2020-04-14 20:00:00,537,3060,204455,203180,203180,12,54,227,6207,766,6973
20200423,FL,28832,267876,1301,2020-04-23 20:00:00,979,4693,298009,296708,296708,12,69,224,7558,523,8081
20200328,FL,3763,35366,null,2020-03-28 20:00:00,54,526,39129,39129,39129,12,20,70,7180,998,8178
20200430,FL,33690,348715,1187,2020-04-30 20:00:00,1290,5795,383592,382405,382405,12,50,171,8420,497,8917
20200326,FL,2355,23741,1443,2020-03-26 20:00:00,28,406,27539,26096,26096,12,6,90,8367,673,9040
20200409,FL,16364,136185,1395,2020-04-09 20:00:00,354,2268,153944,152549,152549,12,45,206,8506,909,9415
20200419,FL,25996,230083,1179,2020-04-19 20:00:00,781,3930,257258,256079,256079,12,27,88,8825,727,9552
20200412,FL,19355,163398,1297,2020-04-12 20:00:00,465,2772,184050,182753,182753,12,27,111,8959,861,9820
20200406,FL,13324,109950,1142,2020-04-06 20:00:00,236,1682,124416,123274,123274,12,18,110,8697,1173,9870
20200411,FL,18494,154439,1418,2020-04-11 20:00:00,438,2661,174351,172933,172933,12,48,174,9140,963,10103
20200420,FL,26660,239565,1104,2020-04-20 20:00:00,806,4010,267329,266225,266225,12,25,80,9482,664,10146
20200410,FL,17531,145299,1411,2020-04-10 20:00:00,390,2487,164241,162830,162830,12,36,219,9114,1167,10281
20200415,FL,22511,190998,1335,2020-04-15 20:00:00,609,3344,214844,213509,213509,12,72,284,9185,1144,10329
20200404,FL,11111,90956,1281,2020-04-04 20:00:00,191,1462,103348,102067,102067,12,28,175,8819,1526,10345
20200330,FL,5473,48225,null,2020-03-30 20:00:00,63,652,53698,53698,53698,12,7,58,9155,1227,10382
20200428,FL,32846,334029,1216,2020-04-28 20:00:00,1154,5266,368091,366875,366875,12,53,55,9704,708,10412
20200402,FL,8010,69286,1285,2020-04-02 20:00:00,128,1123,78581,77296,77296,12,41,174,9757,1055,10812
20200421,FL,27495,249564,1203,2020-04-21 20:00:00,856,4235,278262,277059,277059,12,50,225,9999,835,10834
20200510,FL,40596,498352,1265,2020-05-10 20:00:00,1791,7404,540213,538948,538948,12,6,79,10622,595,11217
20200405,FL,12151,101253,1129,2020-04-05 20:00:00,218,1572,114533,113404,113404,12,27,110,10297,1040,11337
20200426,FL,31528,313085,1183,2020-04-26 20:00:00,1094,5155,345796,344613,344613,12,19,110,10825,689,11514
20200422,FL,28309,260318,1258,2020-04-22 20:00:00,910,4469,289885,288627,288627,12,54,234,10754,814,11568
20200418,FL,25269,221258,0,2020-04-18 20:00:00,754,3842,246527,246527,246527,12,55,177,10540,1150,11690
20200427,FL,32138,324325,1099,2020-04-27 20:00:00,1101,5211,357562,356463,356463,12,7,56,11240,610,11850
20200503,FL,36078,392111,1226,2020-05-03 20:00:00,1403,6244,429415,428189,428189,12,15,299,11562,615,12177
20200507,FL,38828,454122,1499,2020-05-07 20:00:00,1667,6990,494449,492950,492950,12,62,214,12073,826,12899
20200502,FL,35463,380549,null,2020-05-02 20:00:00,1388,5945,416012,416012,416012,12,74,150,12578,735,13313
20200413,FL,20601,175606,1789,2020-04-13 20:00:00,483,2833,197996,196207,196207,12,18,61,12208,1246,13454
20200506,FL,38002,442049,1351,2020-05-06 20:00:00,1605,6776,481402,480051,480051,12,69,230,13797,563,14360
20200509,FL,40001,487730,1452,2020-05-09 20:00:00,1785,7325,529183,527731,527731,12,47,168,13588,802,14390
20200403,FL,9585,82137,1225,2020-04-03 20:00:00,163,1287,92947,91722,91722,12,35,164,12851,1575,14426
20200407,FL,14747,123415,1407,2020-04-07 20:00:00,296,1999,139569,138162,138162,12,60,317,13465,1423,14888
20200417,FL,24119,210718,1285,2020-04-17 20:00:00,699,3665,236122,234837,234837,12,53,205,14367,1222,15589
20200504,FL,36897,407373,1181,2020-05-04 20:00:00,1423,6329,445451,444270,444270,12,20,85,15262,819,16081
20200425,FL,30839,302260,1292,2020-04-25 20:00:00,1075,5045,334391,333099,333099,12,44,157,15475,665,16140
20200424,FL,30174,286785,1287,2020-04-24 20:00:00,1031,4888,318246,316959,316959,12,52,195,18909,1342,20251
20200501,FL,34728,367971,null,2020-05-01 20:00:00,1314,5795,402699,402699,402699,12,24,0,19256,1038,20294
20200508,FL,39199,474142,1433,2020-05-08 20:00:00,1738,7157,514774,513341,513341,12,71,167,20020,371,20391
20200505,FL,37439,428252,1265,2020-05-05 20:00:00,1536,6546,466956,465691,465691,12,113,217,20879,542,21421
20200511,FL,40982,520075,1080,2020-05-11 20:00:00,1805,7458,562137,561057,561057,12,14,54,21723,386,22109
20200304,FL,2,24,16,2020-03-04 21:00:00,null,null,42,26,26,12,null,null,null,null,null
20200306,GA,2,null,null,2020-03-06 21:00:00,null,null,2,2,2,13,0,0,0,0,0
20200305,GA,2,null,null,2020-03-05 21:00:00,null,null,2,2,2,13,0,0,0,0,0
20200308,GA,7,null,null,2020-03-08 20:00:00,null,null,7,7,7,13,0,0,0,1,1
20200307,GA,6,null,null,2020-03-07 21:00:00,null,null,6,6,6,13,0,0,0,4,4
20200311,GA,22,null,null,2020-03-11 20:00:00,null,null,22,22,22,13,0,0,0,5,5
20200310,GA,17,null,null,2020-03-10 20:00:00,null,null,17,17,17,13,0,0,0,5,5
20200309,GA,12,null,null,2020-03-09 20:00:00,null,null,12,12,12,13,0,0,0,5,5
20200312,GA,31,null,null,2020-03-12 20:00:00,null,null,31,31,31,13,0,0,0,9,9
20200313,GA,42,null,null,2020-03-13 20:00:00,1,null,42,42,42,13,1,0,0,11,11
20200316,GA,121,null,null,2020-03-16 20:00:00,1,null,121,121,121,13,0,0,0,22,22
20200314,GA,66,null,null,2020-03-14 20:00:00,1,null,66,66,66,13,0,0,0,24,24
20200317,GA,146,null,null,2020-03-17 20:00:00,1,null,146,146,146,13,0,0,0,25,25
20200315,GA,99,null,null,2020-03-15 20:00:00,1,null,99,99,99,13,0,0,0,33,33
20200330,GA,2809,9915,null,2020-03-30 20:00:00,87,707,12724,12724,12724,13,7,41,2,158,160
20200503,GA,28602,146494,null,2020-05-03 20:00:00,1177,5393,175096,175096,175096,13,3,6,0,296,296
20200319,GA,287,1544,null,2020-03-19 20:00:00,10,null,1831,1831,1831,13,9,0,233,90,323
20200324,GA,1026,4458,null,2020-03-24 20:00:00,32,null,5484,5484,5484,13,7,0,161,254,415
20200320,GA,420,1966,null,2020-03-20 20:00:00,13,null,2386,2386,2386,13,3,0,422,133,555
20200321,GA,507,2557,null,2020-03-21 20:00:00,14,null,3064,3064,3064,13,1,0,591,87,678
20200325,GA,1247,4932,null,2020-03-25 20:00:00,40,394,6179,6179,6179,13,8,394,474,221,695
20200327,GA,2001,7864,null,2020-03-27 20:00:00,64,566,9865,9865,9865,13,16,93,463,476,939
20200322,GA,600,3420,null,2020-03-22 20:00:00,23,null,4020,4020,4020,13,9,0,863,93,956
20200404,GA,6160,20134,null,2020-04-04 20:00:00,201,1239,26294,26294,26294,13,17,81,700,329,1029
20200323,GA,772,4297,null,2020-03-23 20:00:00,25,null,5069,5069,5069,13,2,0,877,172,1049
20200328,GA,2366,8685,null,2020-03-28 20:00:00,69,617,11051,11051,11051,13,5,51,821,365,1186
20200318,GA,197,1311,null,2020-03-18 20:00:00,1,null,1508,1508,1508,13,0,0,1311,51,1362
20200329,GA,2651,9913,null,2020-03-29 20:00:00,80,666,12564,12564,12564,13,11,49,1228,285,1513
20200405,GA,6647,21185,null,2020-04-05 20:00:00,211,1283,27832,27832,27832,13,10,44,1051,487,1538
20200415,GA,14987,49103,null,2020-04-15 20:00:00,552,2922,64090,64090,64090,13,51,153,1531,764,2295
20200409,GA,10566,30519,null,2020-04-09 20:00:00,379,2159,41085,41085,41085,13,17,166,1633,665,2298
20200403,GA,5831,19434,null,2020-04-03 20:00:00,184,1158,25265,25265,25265,13,21,102,1825,483,2308
20200407,GA,8818,24895,null,2020-04-07 20:00:00,329,1774,33713,33713,33713,13,100,442,935,1504,2439
20200418,GA,17669,56539,null,2020-04-18 20:00:00,673,3420,74208,74208,74208,13,23,96,2049,475,2524
20200413,GA,13315,43706,null,2020-04-13 20:00:00,464,2589,57021,57021,57021,13,31,84,1705,863,2568
20200402,GA,5348,17609,null,2020-04-02 20:00:00,163,1056,22957,22957,22957,13,24,104,1921,710,2631
20200412,GA,12452,42001,null,2020-04-12 20:00:00,433,2505,54453,54453,54453,13,5,26,2445,293,2738
20200326,GA,1525,7401,null,2020-03-26 20:00:00,48,473,8926,8926,8926,13,8,79,2469,278,2747
20200506,GA,30696,173441,null,2020-05-06 20:00:00,1311,5765,204137,204137,204137,13,23,131,2269,985,3254
20200406,GA,7314,23960,null,2020-04-06 20:00:00,229,1332,31274,31274,31274,13,18,49,2775,667,3442
20200331,GA,3929,12252,null,2020-03-31 20:00:00,111,833,16181,16181,16181,13,24,126,2337,1120,3457
20200417,GA,17194,54490,null,2020-04-17 20:00:00,650,3324,71684,71684,71684,13,63,216,2220,1525,3745
20200421,GA,19881,68259,null,2020-04-21 20:00:00,799,3779,88140,88140,88140,13,66,229,2878,934,3812
20200416,GA,15669,52270,null,2020-04-16 20:00:00,587,3108,67939,67939,67939,13,35,186,3167,682,3849
20200429,GA,25572,118367,null,2020-04-29 20:00:00,1093,5056,143939,143939,143939,13,67,242,2962,957,3919
20200427,GA,23913,103256,null,2020-04-27 20:00:00,971,4681,127169,127169,127169,13,59,322,3434,512,3946
20200401,GA,4638,15688,null,2020-04-01 20:00:00,139,952,20326,20326,20326,13,28,119,3436,709,4145
20200426,GA,23401,99822,null,2020-04-26 20:00:00,912,4359,123223,123223,123223,13,8,33,3503,706,4209
20200420,GA,18947,65381,null,2020-04-20 20:00:00,733,3550,84328,84328,84328,13,46,86,3749,646,4395
20200414,GA,14223,47572,null,2020-04-14 20:00:00,501,2769,61795,61795,61795,13,37,180,3866,908,4774
20200410,GA,11483,34664,null,2020-04-10 20:00:00,416,2351,46147,46147,46147,13,37,192,4145,917,5062
20200408,GA,9901,28886,null,2020-04-08 20:00:00,362,1993,38787,38787,38787,13,33,219,3991,1083,5074
20200430,GA,26155,122889,null,2020-04-30 20:00:00,1120,5156,149044,149044,149044,13,27,100,4522,583,5105
20200411,GA,12159,39556,null,2020-04-11 20:00:00,428,2479,51715,51715,51715,13,12,128,4892,676,5568
20200419,GA,18301,61632,null,2020-04-19 20:00:00,687,3464,79933,79933,79933,13,14,44,5093,632,5725
20200422,GA,20740,73332,null,2020-04-22 20:00:00,836,3959,94072,94072,94072,13,37,180,5073,859,5932
20200424,GA,22147,85029,null,2020-04-24 20:00:00,892,4221,107176,107176,107176,13,20,152,5479,635,6114
20200502,GA,28306,146494,null,2020-05-02 20:00:00,1174,5387,174800,174800,174800,13,20,118,5397,1036,6433
20200423,GA,21512,79550,null,2020-04-23 20:00:00,872,4069,101062,101062,101062,13,36,110,6218,772,6990
20200511,GA,33927,217361,null,2020-05-11 20:00:00,1441,6015,251288,251288,251288,13,36,18,7255,486,7741
20200509,GA,32532,202792,null,2020-05-09 20:00:00,1400,5987,235324,235324,235324,13,23,52,7331,426,7757
20200510,GA,33441,210106,null,2020-05-10 20:00:00,1405,5997,243547,243547,243547,13,5,10,7314,909,8223
20200504,GA,29368,153957,null,2020-05-04 20:00:00,1222,5526,183325,183325,183325,13,45,133,7463,766,8229
20200508,GA,32106,195461,null,2020-05-08 20:00:00,1377,5935,227567,227567,227567,13,41,100,9597,667,10264
20200425,GA,22695,96319,null,2020-04-25 20:00:00,904,4326,119014,119014,119014,13,12,105,11290,548,11838
20200428,GA,24615,115405,null,2020-04-28 20:00:00,1026,4814,140020,140020,140020,13,55,133,12149,702,12851
20200507,GA,31439,185864,null,2020-05-07 20:00:00,1336,5835,217303,217303,217303,13,25,70,12423,743,13166
20200505,GA,29711,171172,null,2020-05-05 20:00:00,1288,5634,200883,200883,200883,13,66,108,17215,343,17558
20200501,GA,27270,141097,null,2020-05-01 20:00:00,1154,5269,168367,168367,168367,13,34,113,18208,1115,19323
20200304,GA,2,null,null,2020-03-04 21:00:00,null,null,2,2,2,13,null,null,null,null,null
20200510,GU,151,3643,null,2020-05-10 20:00:00,5,null,3794,3794,3794,66,0,0,0,0,0
20200419,GU,133,943,null,2020-04-19 20:00:00,5,null,1076,1076,1076,66,0,0,0,0,0
20200412,GU,133,693,null,2020-04-12 20:00:00,5,null,826,826,826,66,0,0,0,0,0
20200418,GU,133,943,null,2020-04-18 20:00:00,5,null,1076,1076,1076,66,0,0,3,0,3
20200328,GU,55,299,null,2020-03-28 20:00:00,1,null,354,354,354,66,0,0,0,4,4
20200406,GU,113,505,null,2020-04-06 20:00:00,4,null,618,618,618,66,0,0,12,1,13
20200319,GU,12,69,null,2020-03-19 20:00:00,null,null,81,81,81,66,0,0,12,4,16
20200509,GU,151,3643,null,2020-05-09 20:00:00,5,null,3794,3794,3794,66,0,0,17,0,17
20200403,GU,84,459,null,2020-04-03 20:00:00,4,null,543,543,543,66,1,0,17,2,19
20200320,GU,14,86,null,2020-03-20 20:00:00,null,null,100,100,100,66,0,0,17,2,19
20200318,GU,8,57,null,2020-03-18 20:00:00,null,null,65,65,65,66,0,0,16,3,19
20200330,GU,58,352,null,2020-03-30 20:00:00,1,null,410,410,410,66,0,0,18,2,20
20200317,GU,5,41,null,2020-03-17 20:00:00,null,null,46,46,46,66,0,0,18,2,20
20200404,GU,93,472,null,2020-04-04 20:00:00,4,null,565,565,565,66,0,0,13,9,22
20200321,GU,15,108,null,2020-03-21 20:00:00,null,null,123,123,123,66,0,0,22,1,23
20200416,GU,133,870,null,2020-04-16 20:00:00,5,null,1003,1003,1003,66,0,0,27,0,27
20200331,GU,69,371,null,2020-03-31 20:00:00,2,null,440,440,440,66,1,0,19,11,30
20200322,GU,27,126,null,2020-03-22 20:00:00,1,null,153,153,153,66,1,0,18,12,30
20200415,GU,133,843,null,2020-04-15 20:00:00,5,null,976,976,976,66,0,0,32,0,32
20200407,GU,121,529,null,2020-04-07 20:00:00,4,null,650,650,650,66,0,0,24,8,32
20200411,GU,133,693,null,2020-04-11 20:00:00,5,null,826,826,826,66,1,0,31,3,34
20200409,GU,128,593,null,2020-04-09 20:00:00,4,null,721,721,721,66,0,0,31,3,34
20200329,GU,56,334,null,2020-03-29 20:00:00,1,null,390,390,390,66,0,0,35,1,36
20200408,GU,125,562,null,2020-04-08 20:00:00,4,null,687,687,687,66,0,0,33,4,37
20200325,GU,37,233,null,2020-03-25 20:00:00,1,null,270,270,270,66,0,0,32,5,37
20200323,GU,29,161,null,2020-03-23 20:00:00,1,null,190,190,190,66,0,0,35,2,37
20200326,GU,45,263,null,2020-03-26 20:00:00,1,null,308,308,308,66,0,0,30,8,38
20200427,GU,144,1424,null,2020-04-27 20:00:00,5,null,1568,1568,1568,66,0,0,37,3,40
20200405,GU,112,493,null,2020-04-05 20:00:00,4,null,605,605,605,66,0,0,21,19,40
20200414,GU,133,811,null,2020-04-14 20:00:00,5,null,944,944,944,66,0,0,41,0,41
20200402,GU,82,442,null,2020-04-02 20:00:00,3,null,524,524,524,66,0,0,36,5,41
20200421,GU,133,1033,null,2020-04-21 20:00:00,5,null,1166,1166,1166,66,0,0,42,0,42
20200327,GU,51,299,null,2020-03-27 20:00:00,1,null,350,350,350,66,0,0,36,6,42
20200401,GU,77,406,null,2020-04-01 20:00:00,3,null,483,483,483,66,1,0,35,8,43
20200324,GU,32,201,null,2020-03-24 20:00:00,1,null,233,233,233,66,0,0,40,3,43
20200420,GU,133,991,null,2020-04-20 20:00:00,5,null,1124,1124,1124,66,0,0,48,0,48
20200422,GU,134,1086,null,2020-04-22 20:00:00,5,null,1220,1220,1220,66,0,0,53,1,54
20200424,GU,141,1233,null,2020-04-24 20:00:00,5,null,1374,1374,1374,66,0,0,53,6,59
20200508,GU,151,3626,null,2020-05-08 20:00:00,5,null,3777,3777,3777,66,0,0,62,0,62
20200417,GU,133,940,null,2020-04-17 20:00:00,5,null,1073,1073,1073,66,0,0,70,0,70
20200410,GU,130,662,null,2020-04-10 20:00:00,4,null,792,792,792,66,0,0,69,2,71
20200425,GU,141,1308,null,2020-04-25 20:00:00,5,null,1449,1449,1449,66,0,0,75,0,75
20200413,GU,133,770,null,2020-04-13 20:00:00,5,null,903,903,903,66,0,0,77,0,77
20200426,GU,141,1387,null,2020-04-26 20:00:00,5,null,1528,1528,1528,66,0,0,79,0,79
20200507,GU,151,3564,null,2020-05-07 20:00:00,5,null,3715,3715,3715,66,0,0,88,0,88
20200504,GU,149,3242,null,2020-05-04 20:00:00,5,null,3391,3391,3391,66,0,0,90,-1,89
20200423,GU,135,1180,null,2020-04-23 20:00:00,5,null,1315,1315,1315,66,0,0,94,1,95
20200505,GU,149,3341,null,2020-05-05 20:00:00,5,null,3490,3490,3490,66,0,0,99,0,99
20200503,GU,150,3152,null,2020-05-03 20:00:00,5,null,3302,3302,3302,66,0,0,112,2,114
20200428,GU,145,1538,null,2020-04-28 20:00:00,5,null,1683,1683,1683,66,0,0,114,1,115
20200506,GU,151,3476,null,2020-05-06 20:00:00,5,null,3627,3627,3627,66,0,0,135,2,137
20200429,GU,145,1702,null,2020-04-29 20:00:00,5,null,1847,1847,1847,66,0,0,164,0,164
20200502,GU,148,3040,null,2020-05-02 20:00:00,5,null,3188,3188,3188,66,0,0,181,2,183
20200511,GU,151,3838,null,2020-05-11 20:00:00,5,null,3989,3989,3989,66,0,0,195,0,195
20200430,GU,146,1962,null,2020-04-30 20:00:00,5,null,2108,2108,2108,66,0,0,260,1,261
20200501,GU,146,2859,null,2020-05-01 20:00:00,5,null,3005,3005,3005,66,0,0,897,0,897
20200316,GU,3,23,null,2020-03-16 20:00:00,null,null,26,26,26,66,null,null,null,null,null
20200509,HI,629,35633,null,2020-05-09 20:00:00,17,81,36262,36262,36262,15,0,7,-356,0,-356
20200315,HI,2,null,null,2020-03-15 20:00:00,null,null,2,2,2,15,0,0,0,0,0
20200314,HI,2,null,null,2020-03-14 20:00:00,null,null,2,2,2,15,0,0,0,0,0
20200313,HI,2,null,null,2020-03-13 20:00:00,null,null,2,2,2,15,0,0,0,0,0
20200312,HI,2,null,null,2020-03-12 20:00:00,null,null,2,2,2,15,0,0,0,0,0
20200311,HI,2,null,null,2020-03-11 20:00:00,null,null,2,2,2,15,0,0,0,0,0
20200310,HI,2,null,null,2020-03-10 20:00:00,null,null,2,2,2,15,0,0,0,0,0
20200308,HI,1,null,null,2020-03-08 20:00:00,null,null,1,1,1,15,0,0,0,0,0
20200309,HI,2,null,null,2020-03-09 20:00:00,null,null,2,2,2,15,0,0,0,1,1
20200319,HI,16,93,null,2020-03-19 20:00:00,null,null,109,109,109,15,0,0,0,2,2
20200317,HI,10,null,null,2020-03-17 20:00:00,null,null,10,10,10,15,0,0,0,3,3
20200326,HI,95,4357,null,2020-03-26 20:00:00,null,5,4452,4452,4452,15,0,-1,0,5,5
20200316,HI,7,null,null,2020-03-16 20:00:00,null,null,7,7,7,15,0,0,0,5,5
20200327,HI,106,4357,null,2020-03-27 20:00:00,null,7,4463,4463,4463,15,0,2,0,11,11
20200321,HI,37,124,null,2020-03-21 20:00:00,null,null,161,161,161,15,0,0,0,11,11
20200328,HI,120,4357,null,2020-03-28 20:00:00,null,8,4477,4477,4477,15,0,1,0,14,14
20200407,HI,387,13155,null,2020-04-07 20:00:00,5,26,13542,13542,13542,15,1,5,0,16,16
20200403,HI,285,10206,null,2020-04-03 20:00:00,2,15,10491,10491,10491,15,1,0,0,27,27
20200320,HI,26,124,null,2020-03-20 20:00:00,null,null,150,150,150,15,0,0,31,10,41
20200318,HI,14,93,null,2020-03-18 20:00:00,null,null,107,107,107,15,0,0,93,4,97
20200505,HI,621,33378,null,2020-05-05 20:00:00,17,73,33999,33999,33999,15,0,0,132,1,133
20200322,HI,48,263,null,2020-03-22 20:00:00,null,null,311,311,311,15,0,0,139,11,150
20200428,HI,607,28576,null,2020-04-28 20:00:00,16,68,29183,29183,29183,15,2,0,172,1,173
20200401,HI,208,8721,null,2020-04-01 20:00:00,1,13,8929,8929,8929,15,1,1,250,4,254
20200507,HI,626,34915,null,2020-05-07 20:00:00,17,74,35541,35541,35541,15,0,1,341,1,342
20200415,HI,517,19286,null,2020-04-15 20:00:00,9,45,19803,19803,19803,15,0,1,370,13,383
20200410,HI,442,15707,null,2020-04-10 20:00:00,6,42,16149,16149,16149,15,1,0,391,7,398
20200511,HI,632,37051,null,2020-05-11 20:00:00,17,81,37683,37683,37683,15,0,0,412,1,413
20200429,HI,609,29009,null,2020-04-29 20:00:00,16,69,29618,29618,29618,15,0,1,433,2,435
20200412,HI,486,17482,null,2020-04-12 20:00:00,8,44,17968,17968,17968,15,0,1,416,21,437
20200426,HI,603,27880,null,2020-04-26 20:00:00,14,68,28483,28483,28483,15,1,1,441,2,443
20200501,HI,618,30476,null,2020-05-01 20:00:00,16,70,31094,31094,31094,15,0,1,449,5,454
20200418,HI,553,21790,null,2020-04-18 20:00:00,9,48,22343,22343,22343,15,0,3,474,12,486
20200421,HI,584,24112,null,2020-04-21 20:00:00,10,55,24696,24696,24696,15,0,3,517,4,521
20200427,HI,606,28404,null,2020-04-27 20:00:00,14,68,29010,29010,29010,15,0,0,524,3,527
20200406,HI,371,13155,null,2020-04-06 20:00:00,4,21,13526,13526,13526,15,0,2,551,20,571
20200414,HI,504,18916,null,2020-04-14 20:00:00,9,44,19420,19420,19420,15,0,0,571,5,576
20200409,HI,435,15316,null,2020-04-09 20:00:00,5,42,15751,15751,15751,15,0,0,577,25,602
20200422,HI,582,24760,null,2020-04-22 20:00:00,12,56,25342,25342,25342,15,2,1,648,-2,646
20200324,HI,77,3589,null,2020-03-24 20:00:00,null,4,3666,3666,3666,15,0,4,634,21,655
20200331,HI,204,8471,null,2020-03-31 20:00:00,null,12,8675,8675,8675,15,0,0,646,29,675
20200405,HI,351,12604,null,2020-04-05 20:00:00,4,19,12955,12955,12955,15,1,1,645,32,677
20200420,HI,580,23595,null,2020-04-20 20:00:00,10,52,24175,24175,24175,15,1,1,699,6,705
20200424,HI,596,26291,null,2020-04-24 20:00:00,12,63,26887,26887,26887,15,0,0,755,4,759
20200325,HI,90,4357,null,2020-03-25 20:00:00,null,6,4447,4447,4447,15,0,2,768,13,781
20200423,HI,592,25536,null,2020-04-23 20:00:00,12,63,26128,26128,26128,15,0,7,776,10,786
20200413,HI,499,18345,null,2020-04-13 20:00:00,9,44,18844,18844,18844,15,1,0,863,13,876
20200502,HI,619,31366,null,2020-05-02 20:00:00,16,72,31985,31985,31985,15,0,2,890,1,891
20200416,HI,530,20170,null,2020-04-16 20:00:00,9,45,20700,20700,20700,15,0,0,884,13,897
20200504,HI,620,33246,null,2020-05-04 20:00:00,17,73,33866,33866,33866,15,1,1,916,0,916
20200503,HI,620,32330,null,2020-05-03 20:00:00,16,72,32950,32950,32950,15,0,0,964,1,965
20200330,HI,175,7825,null,2020-03-30 20:00:00,null,12,8000,8000,8000,15,0,0,976,24,1000
20200510,HI,631,36639,null,2020-05-10 20:00:00,17,81,37270,37270,37270,15,0,0,1006,2,1008
20200430,HI,613,30027,null,2020-04-30 20:00:00,16,69,30640,30640,30640,15,0,0,1018,4,1022
20200508,HI,629,35989,null,2020-05-08 20:00:00,17,74,36618,36618,36618,15,0,0,1074,3,1077
20200419,HI,574,22896,null,2020-04-19 20:00:00,9,51,23470,23470,23470,15,0,3,1106,21,1127
20200425,HI,601,27439,null,2020-04-25 20:00:00,13,67,28040,28040,28040,15,1,4,1148,5,1153
20200417,HI,541,21316,null,2020-04-17 20:00:00,9,45,21857,21857,21857,15,0,0,1146,11,1157
20200506,HI,625,34574,null,2020-05-06 20:00:00,17,73,35199,35199,35199,15,0,0,1196,4,1200
20200411,HI,465,17066,null,2020-04-11 20:00:00,8,43,17531,17531,17531,15,2,1,1359,23,1382
20200402,HI,258,10206,null,2020-04-02 20:00:00,1,15,10464,10464,10464,15,0,2,1485,50,1535
20200408,HI,410,14739,null,2020-04-08 20:00:00,5,42,15149,15149,15149,15,0,16,1584,23,1607
20200404,HI,319,11959,null,2020-04-04 20:00:00,3,18,12278,12278,12278,15,1,3,1753,34,1787
20200329,HI,151,6849,null,2020-03-29 20:00:00,null,12,7000,7000,7000,15,0,4,2492,31,2523
20200323,HI,56,2955,null,2020-03-23 20:00:00,null,null,3011,3011,3011,15,0,0,2692,8,2700
20200307,HI,1,null,null,2020-03-07 21:00:00,null,null,1,1,1,15,null,null,null,null,null
20200308,IA,0,15,2,2020-03-08 20:00:00,null,null,17,15,15,19,0,0,0,0,0
20200307,IA,0,15,2,2020-03-07 21:00:00,null,null,17,15,15,19,0,0,0,0,0
20200317,IA,23,83,null,2020-03-17 20:00:00,null,null,106,106,106,19,0,0,0,1,1
20200315,IA,18,83,null,2020-03-15 20:00:00,null,null,101,101,101,19,0,0,0,1,1
20200314,IA,17,83,null,2020-03-14 20:00:00,null,null,100,100,100,19,0,0,0,1,1
20200316,IA,22,83,null,2020-03-16 20:00:00,null,null,105,105,105,19,0,0,0,4,4
20200318,IA,29,83,null,2020-03-18 20:00:00,null,null,112,112,112,19,0,0,0,6,6
20200319,IA,38,83,null,2020-03-19 20:00:00,null,null,121,121,121,19,0,0,0,9,9
20200310,IA,8,32,11,2020-03-10 20:00:00,null,null,51,40,40,19,0,0,6,5,11
20200309,IA,3,26,8,2020-03-09 20:00:00,null,null,37,29,29,19,0,0,11,3,14
20200313,IA,16,83,29,2020-03-13 20:00:00,null,null,128,99,99,19,0,0,16,2,18
20200311,IA,13,46,27,2020-03-11 20:00:00,null,null,86,59,59,19,0,0,14,5,19
20200312,IA,14,67,24,2020-03-12 20:00:00,null,null,105,81,81,19,0,0,21,1,22
20200326,IA,179,2578,null,2020-03-26 20:00:00,1,46,2757,2757,2757,19,0,10,0,34,34
20200322,IA,90,1215,null,2020-03-22 20:00:00,null,null,1305,1305,1305,19,0,0,166,22,188
20200414,IA,1899,16986,null,2020-04-14 20:00:00,49,null,18885,18885,18885,19,6,0,0,189,189
20200325,IA,145,2578,null,2020-03-25 20:00:00,1,36,2723,2723,2723,19,1,9,263,21,284
20200324,IA,124,2315,null,2020-03-24 20:00:00,null,27,2439,2439,2439,19,0,27,272,19,291
20200321,IA,68,1049,null,2020-03-21 20:00:00,null,null,1117,1117,1117,19,0,0,407,23,430
20200412,IA,1587,16005,null,2020-04-12 20:00:00,41,null,17592,17592,17592,19,7,0,383,77,460
20200401,IA,549,7304,null,2020-04-01 20:00:00,9,99,7853,7853,7853,19,2,5,416,52,468
20200320,IA,45,642,null,2020-03-20 20:00:00,null,null,687,687,687,19,0,0,559,7,566
20200405,IA,868,9973,null,2020-04-05 20:00:00,22,165,10841,10841,10841,19,8,12,519,82,601
20200422,IA,3748,24496,null,2020-04-22 20:00:00,90,null,28244,28244,28244,19,7,0,522,107,629
20200329,IA,336,5013,null,2020-03-29 20:00:00,4,68,5349,5349,5349,19,1,7,638,38,676
20200328,IA,298,4375,null,2020-03-28 20:00:00,3,61,4673,4673,4673,19,0,11,635,63,698
20200502,IA,8641,37708,null,2020-05-02 20:00:00,175,null,46349,46349,46349,19,5,0,0,757,757
20200406,IA,946,10653,null,2020-04-06 20:00:00,25,179,11599,11599,11599,19,3,14,680,78,758
20200403,IA,699,8754,null,2020-04-03 20:00:00,11,138,9453,9453,9453,19,0,18,700,85,785
20200404,IA,786,9454,null,2020-04-04 20:00:00,14,153,10240,10240,10240,19,3,15,700,87,787
20200331,IA,497,6888,null,2020-03-31 20:00:00,7,94,7385,7385,7385,19,1,20,726,73,799
20200416,IA,2141,18534,null,2020-04-16 20:00:00,60,null,20675,20675,20675,19,7,0,660,146,806
20200402,IA,614,8054,null,2020-04-02 20:00:00,11,120,8668,8668,8668,19,2,21,750,65,815
20200323,IA,105,2043,null,2020-03-23 20:00:00,null,null,2148,2148,2148,19,0,0,828,15,843
20200410,IA,1388,14565,null,2020-04-10 20:00:00,31,null,15953,15953,15953,19,2,0,862,118,980
20200415,IA,1995,17874,null,2020-04-15 20:00:00,53,null,19869,19869,19869,19,4,0,888,96,984
20200409,IA,1270,13703,null,2020-04-09 20:00:00,29,null,14973,14973,14973,19,2,0,882,125,1007
20200423,IA,3924,25338,null,2020-04-23 20:00:00,96,null,29262,29262,29262,19,6,0,842,176,1018
20200413,IA,1710,16986,null,2020-04-13 20:00:00,43,null,18696,18696,18696,19,2,0,981,123,1104
20200417,IA,2332,19460,null,2020-04-17 20:00:00,64,null,21792,21792,21792,19,4,0,926,191,1117
20200407,IA,1048,11670,null,2020-04-07 20:00:00,26,193,12718,12718,12718,19,1,14,1017,102,1119
20200418,IA,2513,20434,null,2020-04-18 20:00:00,74,null,22947,22947,22947,19,10,0,974,181,1155
20200411,IA,1510,15622,null,2020-04-11 20:00:00,34,null,17132,17132,17132,19,3,0,1057,122,1179
20200509,IA,11671,59805,null,2020-05-09 20:00:00,252,null,71476,71476,71476,19,9,0,1001,214,1215
20200327,IA,235,3740,null,2020-03-27 20:00:00,3,50,3975,3975,3975,19,2,4,1162,56,1218
20200330,IA,424,6162,null,2020-03-30 20:00:00,6,74,6586,6586,6586,19,2,6,1149,88,1237
20200408,IA,1145,12821,null,2020-04-08 20:00:00,27,193,13966,13966,13966,19,1,0,1151,97,1248
20200420,IA,3159,22661,null,2020-04-20 20:00:00,79,null,25820,25820,25820,19,4,0,1013,257,1270
20200430,IA,7145,35522,null,2020-04-30 20:00:00,162,null,42667,42667,42667,19,14,0,1028,302,1330
20200429,IA,6843,34494,null,2020-04-29 20:00:00,148,null,41337,41337,41337,19,12,0,1047,467,1514
20200419,IA,2902,21648,null,2020-04-19 20:00:00,75,null,24550,24550,24550,19,1,0,1214,389,1603
20200428,IA,6376,33447,null,2020-04-28 20:00:00,136,null,39823,39823,39823,19,9,0,1165,508,1673
20200426,IA,5476,30614,null,2020-04-26 20:00:00,118,null,36090,36090,36090,19,6,0,1356,384,1740
20200421,IA,3641,23974,null,2020-04-21 20:00:00,83,null,27615,27615,27615,19,4,0,1313,482,1795
20200427,IA,5868,32282,null,2020-04-27 20:00:00,127,null,38150,38150,38150,19,9,0,1668,392,2060
20200425,IA,5092,29258,null,2020-04-25 20:00:00,112,null,34350,34350,34350,19,5,0,1730,647,2377
20200506,IA,10404,52767,null,2020-05-06 20:00:00,219,null,63171,63171,63171,19,12,0,2309,293,2602
20200510,IA,11959,62215,null,2020-05-10 20:00:00,265,null,74174,74174,74174,19,13,0,2410,288,2698
20200424,IA,4445,27528,null,2020-04-24 20:00:00,107,null,31973,31973,31973,19,11,0,2190,521,2711
20200501,IA,7884,37708,null,2020-05-01 20:00:00,170,null,45592,45592,45592,19,8,0,2186,739,2925
20200507,IA,11059,55368,null,2020-05-07 20:00:00,231,null,66427,66427,66427,19,12,0,2601,655,3256
20200505,IA,10111,50458,null,2020-05-05 20:00:00,207,null,60569,60569,60569,19,19,0,3000,408,3408
20200511,IA,12373,65419,null,2020-05-11 20:00:00,271,null,77792,77792,77792,19,6,0,3204,414,3618
20200508,IA,11457,58804,null,2020-05-08 20:00:00,243,null,70261,70261,70261,19,12,0,3436,398,3834
20200504,IA,9703,47458,null,2020-05-04 20:00:00,188,null,57161,57161,57161,19,4,0,3441,534,3975
20200503,IA,9169,44017,null,2020-05-03 20:00:00,184,null,53186,53186,53186,19,9,0,6309,528,6837
20200306,IA,0,15,2,2020-03-06 21:00:00,null,null,17,15,15,19,null,null,null,null,null
20200511,ID,2230,29912,null,2020-05-11 20:00:00,67,207,32142,32142,32142,16,0,0,0,0,0
20200504,ID,2061,27746,null,2020-05-04 20:00:00,64,200,29807,29807,29807,16,1,0,0,0,0
20200310,ID,0,41,null,2020-03-10 20:00:00,null,null,41,41,41,16,0,0,0,0,0
20200308,ID,0,27,null,2020-03-08 20:00:00,null,null,27,27,27,16,0,0,0,0,0
20200319,ID,11,459,null,2020-03-19 20:00:00,null,null,470,470,470,16,0,0,0,2,2
20200315,ID,5,174,null,2020-03-15 20:00:00,null,null,179,179,179,16,0,0,0,3,3
20200309,ID,0,41,null,2020-03-09 20:00:00,null,null,41,41,41,16,0,0,14,0,14
20200325,ID,73,1887,null,2020-03-25 20:00:00,0,null,1960,1960,1960,16,0,0,0,23,23
20200312,ID,0,93,null,2020-03-12 20:00:00,null,null,93,93,93,16,0,0,26,0,26
20200311,ID,0,67,null,2020-03-11 20:00:00,null,null,67,67,67,16,0,0,26,0,26
20200313,ID,0,131,null,2020-03-13 20:00:00,null,null,131,131,131,16,0,0,38,0,38
20200314,ID,2,174,null,2020-03-14 20:00:00,null,null,176,176,176,16,0,0,43,2,45
20200422,ID,1766,15964,null,2020-04-22 20:00:00,51,158,17730,17730,17730,16,3,1,40,30,70
20200317,ID,7,346,null,2020-03-17 20:00:00,null,null,353,353,353,16,0,0,81,2,83
20200316,ID,5,265,null,2020-03-16 20:00:00,null,null,270,270,270,16,0,0,91,0,91
20200318,ID,9,459,null,2020-03-18 20:00:00,null,null,468,468,468,16,0,0,113,2,115
20200323,ID,47,1309,null,2020-03-23 20:00:00,0,null,1356,1356,1356,16,0,0,134,5,139
20200320,ID,23,590,null,2020-03-20 20:00:00,null,null,613,613,613,16,0,0,131,12,143
20200428,ID,1917,18135,null,2020-04-28 20:00:00,58,172,20052,20052,20052,16,2,3,137,20,157
20200426,ID,1887,17678,null,2020-04-26 20:00:00,56,169,19565,19565,19565,16,2,1,187,17,204
20200421,ID,1736,15924,null,2020-04-21 20:00:00,48,157,17660,17660,17660,16,3,6,151,64,215
20200326,ID,123,2065,null,2020-03-26 20:00:00,0,null,2188,2188,2188,16,0,0,178,50,228
20200414,ID,1453,13661,null,2020-04-14 20:00:00,33,135,15114,15114,15114,16,6,3,206,27,233
20200506,ID,2127,28418,null,2020-05-06 20:00:00,65,203,30545,30545,30545,16,1,2,216,21,237
20200407,ID,1170,10076,null,2020-04-07 20:00:00,13,83,11246,11246,11246,16,3,6,182,69,251
20200419,ID,1668,15201,null,2020-04-19 20:00:00,44,151,16869,16869,16869,16,1,0,247,13,260
20200502,ID,2035,27455,null,2020-05-02 20:00:00,63,178,29490,29490,29490,16,0,0,245,20,265
20200425,ID,1870,17491,null,2020-04-25 20:00:00,54,168,19361,19361,19361,16,0,2,236,34,270
20200415,ID,1464,13934,null,2020-04-15 20:00:00,39,141,15398,15398,15398,16,6,6,273,11,284
20200321,ID,31,880,null,2020-03-21 20:00:00,null,null,911,911,911,16,0,0,290,8,298
20200322,ID,42,1175,null,2020-03-22 20:00:00,0,null,1217,1217,1217,16,0,0,295,11,306
20200430,ID,1984,26709,null,2020-04-30 20:00:00,60,175,28693,28693,28693,16,0,2,279,32,311
20200503,ID,2061,27746,null,2020-05-03 20:00:00,63,200,29807,29807,29807,16,0,22,291,26,317
20200427,ID,1897,17998,null,2020-04-27 20:00:00,56,169,19895,19895,19895,16,0,0,320,10,330
20200510,ID,2230,29912,null,2020-05-10 20:00:00,67,207,32142,32142,32142,16,0,1,311,25,336
20200507,ID,2158,28732,null,2020-05-07 20:00:00,66,205,30890,30890,30890,16,1,2,314,31,345
20200417,ID,1609,14574,null,2020-04-17 20:00:00,41,148,16183,16183,16183,16,0,5,330,22,352
20200423,ID,1802,16290,null,2020-04-23 20:00:00,54,162,18092,18092,18092,16,3,4,326,36,362
20200508,ID,2178,29092,null,2020-05-08 20:00:00,67,206,31270,31270,31270,16,1,1,360,20,380
20200330,ID,310,4396,null,2020-03-30 20:00:00,6,39,4706,4706,4706,16,1,3,375,49,424
20200418,ID,1655,14954,null,2020-04-18 20:00:00,43,151,16609,16609,16609,16,2,3,380,46,426
20200416,ID,1587,14244,null,2020-04-16 20:00:00,41,143,15831,15831,15831,16,2,2,310,123,433
20200505,ID,2106,28202,null,2020-05-05 20:00:00,64,201,30308,30308,30308,16,0,1,456,45,501
20200501,ID,2015,27210,null,2020-05-01 20:00:00,63,178,29225,29225,29225,16,3,3,501,31,532
20200509,ID,2205,29601,null,2020-05-09 20:00:00,67,206,31806,31806,31806,16,0,0,509,27,536
20200412,ID,1407,12901,null,2020-04-12 20:00:00,27,131,14308,14308,14308,16,2,3,533,11,544
20200410,ID,1353,11741,null,2020-04-10 20:00:00,24,127,13094,13094,13094,16,6,14,442,121,563
20200413,ID,1426,13455,null,2020-04-13 20:00:00,27,132,14881,14881,14881,16,0,1,554,19,573
20200420,ID,1672,15773,null,2020-04-20 20:00:00,45,151,17445,17445,17445,16,1,0,572,4,576
20200324,ID,50,1887,null,2020-03-24 20:00:00,0,null,1937,1937,1937,16,0,0,578,3,581
20200409,ID,1232,11299,null,2020-04-09 20:00:00,18,113,12531,12531,12531,16,3,20,611,22,633
20200408,ID,1210,10688,null,2020-04-08 20:00:00,15,93,11898,11898,11898,16,2,10,612,40,652
20200403,ID,891,7054,null,2020-04-03 20:00:00,9,56,7945,7945,7945,16,0,7,441,222,663
20200327,ID,189,2668,null,2020-03-27 20:00:00,3,null,2857,2857,2857,16,3,0,603,66,669
20200411,ID,1396,12368,null,2020-04-11 20:00:00,25,128,13764,13764,13764,16,1,1,627,43,670
20200402,ID,669,6613,null,2020-04-02 20:00:00,9,49,7282,7282,7282,16,0,3,537,144,681
20200329,ID,261,4021,null,2020-03-29 20:00:00,5,36,4282,4282,4282,16,1,11,679,31,710
20200328,ID,230,3342,null,2020-03-28 20:00:00,4,25,3572,3572,3572,16,1,25,674,41,715
20200406,ID,1101,9894,null,2020-04-06 20:00:00,10,77,10995,10995,10995,16,0,11,710,24,734
20200401,ID,525,6076,null,2020-04-01 20:00:00,9,46,6601,6601,6601,16,2,1,779,110,889
20200404,ID,1013,7857,null,2020-04-04 20:00:00,10,62,8870,8870,8870,16,1,6,803,122,925
20200424,ID,1836,17255,null,2020-04-24 20:00:00,54,166,19091,19091,19091,16,0,4,965,34,999
20200331,ID,415,5297,null,2020-03-31 20:00:00,7,45,5712,5712,5712,16,1,6,901,105,1006
20200405,ID,1077,9184,null,2020-04-05 20:00:00,10,66,10261,10261,10261,16,0,4,1327,64,1391
20200429,ID,1952,26430,null,2020-04-29 20:00:00,60,173,28382,28382,28382,16,2,1,8295,35,8330
20200307,ID,0,27,null,2020-03-07 21:00:00,null,null,27,27,27,16,null,null,null,null,null
20200311,IL,19,244,63,2020-03-11 20:00:00,null,null,326,263,263,17,0,0,0,0,0
20200308,IL,6,191,44,2020-03-08 20:00:00,null,null,241,197,197,17,0,0,0,0,0
20200309,IL,7,191,44,2020-03-09 20:00:00,null,null,242,198,198,17,0,0,0,1,1
20200307,IL,6,191,44,2020-03-07 21:00:00,null,null,241,197,197,17,0,0,11,1,12
20200306,IL,5,180,35,2020-03-06 21:00:00,null,null,220,185,185,17,0,0,15,0,15
20200312,IL,25,266,76,2020-03-12 20:00:00,null,null,367,291,291,17,0,0,22,6,28
20200313,IL,32,294,92,2020-03-13 20:00:00,null,null,418,326,326,17,0,0,28,7,35
20200314,IL,46,316,82,2020-03-14 20:00:00,null,null,444,362,362,17,0,0,22,14,36
20200305,IL,5,165,27,2020-03-05 21:00:00,null,null,197,170,170,17,0,0,41,1,42
20200310,IL,19,244,63,2020-03-10 20:00:00,null,null,326,263,263,17,0,0,53,12,65
20200315,IL,64,449,195,2020-03-15 20:00:00,null,null,708,513,513,17,0,0,133,18,151
20200317,IL,159,1340,null,2020-03-17 20:00:00,1,null,1499,1499,1499,17,1,0,408,66,474
20200316,IL,93,932,null,2020-03-16 20:00:00,null,null,1025,1025,1025,17,0,0,483,29,512
20200318,IL,288,1763,null,2020-03-18 20:00:00,1,null,2051,2051,2051,17,0,0,423,129,552
20200319,IL,422,2725,null,2020-03-19 20:00:00,4,null,3147,3147,3147,17,3,0,962,134,1096
20200320,IL,585,3696,null,2020-03-20 20:00:00,5,null,4281,4281,4281,17,1,0,971,163,1134
20200323,IL,1273,8583,null,2020-03-23 20:00:00,12,null,9856,9856,9856,17,3,0,1312,224,1536
20200324,IL,1535,9934,null,2020-03-24 20:00:00,16,null,11469,11469,11469,17,4,0,1351,262,1613
20200321,IL,753,5488,null,2020-03-21 20:00:00,6,null,6241,6241,6241,17,1,0,1792,168,1960
20200322,IL,1049,7271,null,2020-03-22 20:00:00,9,null,8320,8320,8320,17,3,0,1783,296,2079
20200329,IL,4596,23166,null,2020-03-29 20:00:00,65,null,27762,27762,27762,17,18,0,1166,1105,2271
20200326,IL,2538,14093,null,2020-03-26 20:00:00,26,null,16631,16631,16631,17,7,0,1749,673,2422
20200330,IL,5057,25389,null,2020-03-30 20:00:00,73,null,30446,30446,30446,17,8,0,2223,461,2684
20200325,IL,1865,12344,null,2020-03-25 20:00:00,19,null,14209,14209,14209,17,3,0,2410,330,2740
20200402,IL,7695,35961,null,2020-04-02 20:00:00,157,null,43656,43656,43656,17,16,0,2557,715,3272
20200328,IL,3491,22000,null,2020-03-28 20:00:00,47,null,25491,25491,25491,17,13,0,3484,465,3949
20200406,IL,12262,50680,null,2020-04-06 20:00:00,307,null,62942,62942,62942,17,33,0,2953,1006,3959
20200403,IL,8904,39144,null,2020-04-03 20:00:00,210,null,48048,48048,48048,17,53,0,3183,1209,4392
20200411,IL,19180,72969,null,2020-04-11 20:00:00,677,null,92149,92149,92149,17,81,0,3329,1293,4622
20200331,IL,5994,29231,null,2020-03-31 20:00:00,99,null,35225,35225,35225,17,26,0,3842,937,4779
20200414,IL,23247,87369,null,2020-04-14 20:00:00,868,null,110616,110616,110616,17,74,0,3626,1222,4848
20200327,IL,3026,18516,null,2020-03-27 20:00:00,34,null,21542,21542,21542,17,8,0,4423,488,4911
20200413,IL,22025,83743,null,2020-04-13 20:00:00,794,null,105768,105768,105768,17,74,0,3860,1173,5033
20200420,IL,31508,116850,null,2020-04-20 20:00:00,1349,null,148358,148358,148358,17,59,0,3889,1151,5040
20200401,IL,6980,33404,null,2020-04-01 20:00:00,141,null,40384,40384,40384,17,42,0,4173,986,5159
20200405,IL,11256,47727,null,2020-04-05 20:00:00,274,null,58983,58983,58983,17,31,0,4503,899,5402
20200404,IL,10357,43224,null,2020-04-04 20:00:00,243,null,53581,53581,53581,17,33,0,4080,1453,5533
20200416,IL,25733,96856,null,2020-04-16 20:00:00,1072,null,122589,122589,122589,17,124,0,4520,1140,5660
20200407,IL,13549,55183,null,2020-04-07 20:00:00,380,null,68732,68732,68732,17,73,0,4503,1287,5790
20200409,IL,16422,64435,null,2020-04-09 20:00:00,528,null,80857,80857,80857,17,66,0,4447,1344,5791
20200419,IL,30357,112961,null,2020-04-19 20:00:00,1290,null,143318,143318,143318,17,31,0,4717,1197,5914
20200415,IL,24593,92336,null,2020-04-15 20:00:00,948,null,116929,116929,116929,17,80,0,4967,1346,6313
20200408,IL,15078,59988,null,2020-04-08 20:00:00,462,null,75066,75066,75066,17,82,0,4805,1529,6334
20200421,IL,33059,121938,null,2020-04-21 20:00:00,1468,null,154997,154997,154997,17,119,0,5088,1551,6639
20200410,IL,17887,69640,null,2020-04-10 20:00:00,596,null,87527,87527,87527,17,68,0,5205,1465,6670
20200418,IL,29160,108244,null,2020-04-18 20:00:00,1259,null,137404,137404,137404,17,125,0,5656,1585,7241
20200417,IL,27575,102588,null,2020-04-17 20:00:00,1134,null,130163,130163,130163,17,62,0,5732,1842,7574
20200412,IL,20852,79883,null,2020-04-12 20:00:00,720,null,100735,100735,100735,17,43,0,6914,1672,8586
20200423,IL,36934,136382,null,2020-04-23 20:00:00,1688,null,173316,173316,173316,17,123,0,7144,1826,8970
20200422,IL,35108,129238,null,2020-04-22 20:00:00,1565,null,164346,164346,164346,17,97,0,7300,2049,9349
20200425,IL,41777,159840,null,2020-04-25 20:00:00,1874,null,201617,201617,201617,17,79,0,9866,2119,11985
20200511,IL,79007,363418,null,2020-05-11 20:00:00,3459,null,442425,442425,442425,17,53,0,11175,1266,12441
20200427,IL,45883,181745,null,2020-04-27 20:00:00,1983,null,227628,227628,227628,17,50,0,10696,1980,12676
20200505,IL,65962,280324,null,2020-05-05 20:00:00,2838,null,346286,346286,346286,17,176,0,11017,2122,13139
20200430,IL,52918,216949,null,2020-04-30 20:00:00,2355,null,269867,269867,269867,17,140,0,10637,2563,13200
20200426,IL,43903,171049,null,2020-04-26 20:00:00,1933,null,214952,214952,214952,17,59,0,11209,2126,13335
20200510,IL,77741,352243,null,2020-05-10 20:00:00,3406,null,429984,429984,429984,17,57,0,11997,1656,13653
20200504,IL,63840,269307,null,2020-05-04 20:00:00,2662,null,333147,333147,333147,17,44,0,11493,2341,13834
20200429,IL,50355,206312,null,2020-04-29 20:00:00,2215,null,256667,256667,256667,17,90,0,12225,2253,14478
20200428,IL,48102,194087,null,2020-04-28 20:00:00,2125,null,242189,242189,242189,17,142,0,12342,2219,14561
20200501,IL,56055,228633,null,2020-05-01 20:00:00,2457,null,284688,284688,284688,17,102,0,11684,3137,14821
20200506,IL,68232,293028,null,2020-05-06 20:00:00,2974,null,361260,361260,361260,17,136,0,12704,2270,14974
20200502,IL,58505,241391,null,2020-05-02 20:00:00,2559,null,299896,299896,299896,17,102,0,12758,2450,15208
20200424,IL,39658,149974,null,2020-04-24 20:00:00,1795,null,189632,189632,189632,17,107,0,13592,2724,16316
20200509,IL,76085,340246,null,2020-05-09 20:00:00,3349,null,416331,416331,416331,17,108,0,14292,2325,16617
20200507,IL,70873,308170,null,2020-05-07 20:00:00,3111,null,379043,379043,379043,17,137,0,15142,2641,17783
20200503,IL,61499,257814,null,2020-05-03 20:00:00,2618,null,319313,319313,319313,17,59,0,16423,2994,19417
20200508,IL,73760,325954,null,2020-05-08 20:00:00,3241,null,399714,399714,399714,17,130,0,17784,2887,20671
20200304,IL,4,124,27,2020-03-04 21:00:00,null,null,155,128,128,17,null,null,null,null,null
20200309,IN,2,null,null,2020-03-09 20:00:00,null,null,2,2,2,18,0,0,0,0,0
20200307,IN,1,null,null,2020-03-07 21:00:00,null,null,1,1,1,18,0,0,0,0,0
20200308,IN,2,null,null,2020-03-08 20:00:00,null,null,2,2,2,18,0,0,0,1,1
20200311,IN,10,33,null,2020-03-11 20:00:00,null,null,43,43,43,18,0,0,3,4,7
20200313,IN,12,61,null,2020-03-13 20:00:00,null,null,73,73,73,18,0,0,9,0,9
20200314,IN,15,74,null,2020-03-14 20:00:00,0,null,89,89,89,18,0,0,13,3,16
20200316,IN,24,115,null,2020-03-16 20:00:00,1,null,139,139,139,18,1,0,13,5,18
20200317,IN,30,129,null,2020-03-17 20:00:00,2,null,159,159,159,18,1,0,14,6,20
20200312,IN,12,52,null,2020-03-12 20:00:00,null,null,64,64,64,18,0,0,19,2,21
20200315,IN,19,102,null,2020-03-15 20:00:00,0,null,121,121,121,18,0,0,28,4,32
20200318,IN,39,154,null,2020-03-18 20:00:00,2,null,193,193,193,18,0,0,25,9,34
20200310,IN,6,30,null,2020-03-10 20:00:00,null,null,36,36,36,18,0,0,30,4,34
20200320,IN,79,475,null,2020-03-20 20:00:00,2,null,554,554,554,18,0,0,151,23,174
20200319,IN,56,324,null,2020-03-19 20:00:00,2,null,380,380,380,18,0,0,170,17,187
20200321,IN,126,707,null,2020-03-21 20:00:00,4,1,833,833,833,18,2,1,232,47,279
20200325,IN,477,2879,null,2020-03-25 20:00:00,14,1,3356,3356,3356,18,2,0,313,112,425
20200323,IN,259,1701,null,2020-03-23 20:00:00,7,1,1960,1960,1960,18,1,0,408,58,466
20200322,IN,201,1293,null,2020-03-22 20:00:00,6,1,1494,1494,1494,18,2,0,586,75,661
20200324,IN,365,2566,null,2020-03-24 20:00:00,12,1,2931,2931,2931,18,5,0,865,106,971
20200401,IN,2565,11810,null,2020-04-01 20:00:00,65,null,14375,14375,14375,18,16,0,596,406,1002
20200409,IN,6351,25782,null,2020-04-09 20:00:00,245,null,32133,32133,32133,18,42,0,856,408,1264
20200326,IN,645,4006,null,2020-03-26 20:00:00,17,null,4651,4651,4651,18,3,0,1127,168,1295
20200329,IN,1514,8316,null,2020-03-29 20:00:00,32,null,9830,9830,9830,18,1,0,1141,282,1423
20200328,IN,1232,7175,null,2020-03-28 20:00:00,31,null,8407,8407,8407,18,7,0,1220,251,1471
20200414,IN,8527,37490,null,2020-04-14 20:00:00,388,null,46017,46017,46017,18,38,0,1187,291,1478
20200403,IN,3437,14398,null,2020-04-03 20:00:00,102,null,17835,17835,17835,18,24,0,1152,398,1550
20200331,IN,2159,11214,null,2020-03-31 20:00:00,49,null,13373,13373,13373,18,14,0,1342,373,1715
20200330,IN,1786,9872,null,2020-03-30 20:00:00,35,null,11658,11658,11658,18,3,0,1556,272,1828
20200402,IN,3039,13246,null,2020-04-02 20:00:00,78,null,16285,16285,16285,18,13,0,1436,474,1910
20200426,IN,15012,66696,null,2020-04-26 20:00:00,813,null,81708,81708,81708,18,28,0,1317,617,1934
20200404,IN,3953,15847,null,2020-04-04 20:00:00,116,null,19800,19800,19800,18,14,0,1449,516,1965
20200413,IN,8236,36303,null,2020-04-13 20:00:00,350,null,44539,44539,44539,18,7,0,1742,308,2050
20200418,IN,10641,46232,null,2020-04-18 20:00:00,545,null,56873,56873,56873,18,26,0,1601,487,2088
20200408,IN,5943,24926,null,2020-04-08 20:00:00,203,null,30869,30869,30869,18,30,0,1669,436,2105
20200422,IN,12438,57032,null,2020-04-22 20:00:00,661,null,69470,69470,69470,18,31,0,1865,341,2206
20200327,IN,981,5955,null,2020-03-27 20:00:00,24,null,6936,6936,6936,18,7,0,1949,336,2285
20200415,IN,8955,39441,null,2020-04-15 20:00:00,436,null,48396,48396,48396,18,48,0,1951,428,2379
20200505,IN,21033,94801,null,2020-05-05 20:00:00,1326,null,115834,115834,115834,18,62,0,2011,526,2537
20200423,IN,13039,59001,null,2020-04-23 20:00:00,706,null,72040,72040,72040,18,45,0,1969,601,2570
20200407,IN,5507,23257,null,2020-04-07 20:00:00,173,null,28764,28764,28764,18,34,0,2010,563,2573
20200421,IN,12097,55167,null,2020-04-21 20:00:00,630,null,67264,67264,67264,18,61,0,2214,411,2625
20200428,IN,16588,70593,null,2020-04-28 20:00:00,901,null,87181,87181,87181,18,57,0,2078,627,2705
20200416,IN,9542,41573,null,2020-04-16 20:00:00,477,null,51115,51115,51115,18,41,0,2132,587,2719
20200427,IN,15961,68515,null,2020-04-27 20:00:00,844,null,84476,84476,84476,18,31,0,1819,949,2768
20200405,IN,4411,18241,null,2020-04-05 20:00:00,127,null,22652,22652,22652,18,11,0,2394,458,2852
20200410,IN,6907,28133,null,2020-04-10 20:00:00,300,null,35040,35040,35040,18,55,0,2351,556,2907
20200412,IN,7928,34561,null,2020-04-12 20:00:00,343,null,42489,42489,42489,18,13,0,2781,493,3274
20200430,IN,17835,77163,null,2020-04-30 20:00:00,1114,null,94998,94998,94998,18,49,0,2795,653,3448
20200420,IN,11686,52953,null,2020-04-20 20:00:00,569,null,64639,64639,64639,18,7,0,3021,476,3497
20200424,IN,13680,61873,null,2020-04-24 20:00:00,741,null,75553,75553,75553,18,35,0,2872,641,3513
20200406,IN,4944,21247,null,2020-04-06 20:00:00,139,null,26191,26191,26191,18,12,0,3006,533,3539
20200417,IN,10154,44631,null,2020-04-17 20:00:00,519,null,54785,54785,54785,18,42,0,3058,612,3670
20200411,IN,7435,31780,null,2020-04-11 20:00:00,330,null,39215,39215,39215,18,30,0,3647,528,4175
20200425,IN,14395,65379,null,2020-04-25 20:00:00,785,null,79774,79774,79774,18,44,0,3506,715,4221
20200419,IN,11210,49932,null,2020-04-19 20:00:00,562,null,61142,61142,61142,18,17,0,3700,569,4269
20200507,IN,22503,102279,null,2020-05-07 20:00:00,1414,null,124782,124782,124782,18,37,0,3653,633,4286
20200510,IN,24126,115903,null,2020-05-10 20:00:00,1508,4389,140029,140029,140029,18,18,0,3949,394,4343
20200429,IN,17182,74368,null,2020-04-29 20:00:00,1065,null,91550,91550,91550,18,164,0,3775,594,4369
20200504,IN,20507,92790,null,2020-05-04 20:00:00,1264,null,113297,113297,113297,18,18,0,3864,574,4438
20200502,IN,19295,84846,null,2020-05-02 20:00:00,1229,null,104141,104141,104141,18,54,0,3837,665,4502
20200501,IN,18630,81009,null,2020-05-01 20:00:00,1175,null,99639,99639,99639,18,61,0,3846,795,4641
20200506,IN,21870,98626,null,2020-05-06 20:00:00,1377,null,120496,120496,120496,18,51,0,3825,837,4662
20200503,IN,19933,88926,null,2020-05-03 20:00:00,1246,null,108859,108859,108859,18,17,0,4080,638,4718
20200508,IN,23146,106982,null,2020-05-08 20:00:00,1447,4389,130128,130128,130128,18,33,4389,4703,643,5346
20200509,IN,23732,111954,null,2020-05-09 20:00:00,1490,4389,135686,135686,135686,18,43,0,4972,586,5558
20200511,IN,24627,122061,null,2020-05-11 20:00:00,1540,4389,146688,146688,146688,18,32,0,6158,501,6659
20200306,IN,1,null,null,2020-03-06 21:00:00,null,null,1,1,1,18,null,null,null,null,null
20200314,KS,6,93,null,2020-03-14 20:00:00,1,null,99,99,99,20,1,0,0,0,0
20200309,KS,1,11,0,2020-03-09 20:00:00,null,null,12,12,12,20,0,0,0,0,0
20200308,KS,1,11,0,2020-03-08 20:00:00,null,null,12,12,12,20,0,0,0,1,1
20200312,KS,4,41,null,2020-03-12 20:00:00,null,null,45,45,45,20,0,0,0,3,3
20200310,KS,1,17,21,2020-03-10 20:00:00,null,null,39,18,18,20,0,0,6,0,6
20200307,KS,0,11,2,2020-03-07 21:00:00,null,null,13,11,11,20,0,0,7,0,7
20200322,KS,64,417,null,2020-03-22 20:00:00,2,null,481,481,481,20,0,0,0,9,9
20200320,KS,44,417,null,2020-03-20 20:00:00,1,null,461,461,461,20,0,0,0,10,10
20200321,KS,55,417,null,2020-03-21 20:00:00,2,null,472,472,472,20,1,0,0,11,11
20200323,KS,82,417,null,2020-03-23 20:00:00,2,null,499,499,499,20,0,0,0,18,18
20200319,KS,34,417,null,2020-03-19 20:00:00,1,null,451,451,451,20,0,0,0,18,18
20200311,KS,1,41,null,2020-03-11 20:00:00,null,null,42,42,42,20,0,0,24,0,24
20200316,KS,11,166,null,2020-03-16 20:00:00,1,null,177,177,177,20,0,0,31,3,34
20200318,KS,16,417,null,2020-03-18 20:00:00,1,null,433,433,433,20,0,0,35,1,36
20200315,KS,8,135,null,2020-03-15 20:00:00,1,null,143,143,143,20,0,0,42,2,44
20200313,KS,6,93,null,2020-03-13 20:00:00,null,null,99,99,99,20,0,0,52,2,54
20200317,KS,15,382,null,2020-03-17 20:00:00,1,null,397,397,397,20,0,0,216,4,220
20200414,KS,1426,12721,null,2020-04-14 20:00:00,69,327,14147,14147,14147,20,7,18,233,50,283
20200325,KS,126,2360,null,2020-03-25 20:00:00,3,null,2486,2486,2486,20,1,0,274,28,302
20200421,KS,2025,17076,null,2020-04-21 20:00:00,107,419,19101,19101,19101,20,7,14,301,39,340
20200327,KS,202,3229,null,2020-03-27 20:00:00,4,27,3431,3431,3431,20,1,27,360,34,394
20200330,KS,368,4554,null,2020-03-30 20:00:00,8,66,4922,4922,4922,20,2,11,360,49,409
20200407,KS,900,8614,null,2020-04-07 20:00:00,27,223,9514,9514,9514,20,2,25,375,55,430
20200419,KS,1849,16281,null,2020-04-19 20:00:00,92,390,18130,18130,18130,20,6,7,395,59,454
20200403,KS,620,6454,null,2020-04-03 20:00:00,17,151,7074,7074,7074,20,4,13,395,68,463
20200401,KS,482,5411,null,2020-04-01 20:00:00,10,114,5893,5893,5893,20,1,35,415,54,469
20200328,KS,261,3671,null,2020-03-28 20:00:00,5,27,3932,3932,3932,20,1,0,442,59,501
20200331,KS,428,4996,null,2020-03-31 20:00:00,9,79,5424,5424,5424,20,1,13,442,60,502
20200404,KS,698,6880,null,2020-04-04 20:00:00,21,172,7578,7578,7578,20,4,21,426,78,504
20200415,KS,1494,13174,null,2020-04-15 20:00:00,76,342,14668,14668,14668,20,7,15,453,68,521
20200326,KS,168,2869,null,2020-03-26 20:00:00,3,null,3037,3037,3037,20,0,0,509,42,551
20200329,KS,319,4194,null,2020-03-29 20:00:00,6,55,4513,4513,4513,20,1,28,523,58,581
20200409,KS,1106,9669,null,2020-04-09 20:00:00,42,263,10775,10775,10775,20,4,40,532,60,592
20200413,KS,1376,12488,null,2020-04-13 20:00:00,62,309,13864,13864,13864,20,6,11,572,39,611
20200420,KS,1986,16775,null,2020-04-20 20:00:00,100,405,18761,18761,18761,20,8,15,494,137,631
20200410,KS,1166,10248,null,2020-04-10 20:00:00,50,274,11414,11414,11414,20,8,11,579,60,639
20200405,KS,747,7476,null,2020-04-05 20:00:00,22,183,8223,8223,8223,20,1,11,596,49,645
20200408,KS,1046,9137,null,2020-04-08 20:00:00,38,223,10183,10183,10183,20,11,0,523,146,669
20200402,KS,552,6059,null,2020-04-02 20:00:00,13,138,6611,6611,6611,20,3,24,648,70,718
20200418,KS,1790,15886,null,2020-04-18 20:00:00,86,383,17676,17676,17676,20,2,8,690,85,775
20200417,KS,1705,15196,null,2020-04-17 20:00:00,84,375,16901,16901,16901,20,4,16,662,117,779
20200406,KS,845,8239,null,2020-04-06 20:00:00,25,198,9084,9084,9084,20,3,15,763,98,861
20200412,KS,1337,11916,null,2020-04-12 20:00:00,56,298,13253,13253,13253,20,1,5,841,69,910
20200428,KS,3491,24599,null,2020-04-28 20:00:00,124,504,28090,28090,28090,20,4,8,760,163,923
20200411,KS,1268,11075,null,2020-04-11 20:00:00,55,293,12343,12343,12343,20,5,19,827,102,929
20200427,KS,3328,23839,null,2020-04-27 20:00:00,120,496,27167,27167,27167,20,2,11,786,154,940
20200426,KS,3174,23053,null,2020-04-26 20:00:00,118,485,26227,26227,26227,20,1,11,910,118,1028
20200422,KS,2211,17992,null,2020-04-22 20:00:00,110,432,20203,20203,20203,20,3,13,916,186,1102
20200423,KS,2482,18836,null,2020-04-23 20:00:00,112,442,21318,21318,21318,20,2,10,844,271,1115
20200429,KS,3738,25720,null,2020-04-29 20:00:00,125,515,29458,29458,29458,20,1,11,1121,247,1368
20200501,KS,4449,28585,null,2020-05-01 20:00:00,130,534,33034,33034,33034,20,1,11,1197,211,1408
20200416,KS,1588,14534,null,2020-04-16 20:00:00,80,359,16122,16122,16122,20,4,17,1360,94,1454
20200505,KS,5458,34634,null,2020-05-05 20:00:00,137,566,40092,40092,40092,20,1,13,1276,213,1489
20200511,KS,7116,46993,null,2020-05-11 20:00:00,158,660,54109,54109,54109,20,1,3,1436,168,1604
20200425,KS,3056,22143,null,2020-04-25 20:00:00,117,474,25199,25199,25199,20,6,17,1332,279,1611
20200324,KS,98,2086,null,2020-03-24 20:00:00,2,null,2184,2184,2184,20,0,0,1669,16,1685
20200504,KS,5245,33358,null,2020-05-04 20:00:00,136,553,38603,38603,38603,20,2,6,1610,215,1825
20200503,KS,5030,31748,null,2020-05-03 20:00:00,134,547,36778,36778,36778,20,3,6,1552,284,1836
20200502,KS,4746,30196,null,2020-05-02 20:00:00,131,541,34942,34942,34942,20,1,7,1611,297,1908
20200506,KS,5734,36380,null,2020-05-06 20:00:00,144,571,42114,42114,42114,20,7,5,1746,276,2022
20200430,KS,4238,27388,null,2020-04-30 20:00:00,129,523,31626,31626,31626,20,4,8,1668,500,2168
20200509,KS,6751,43182,null,2020-05-09 20:00:00,157,635,49933,49933,49933,20,5,27,1975,250,2225
20200424,KS,2777,20811,null,2020-04-24 20:00:00,111,457,23588,23588,23588,20,-1,15,1975,295,2270
20200510,KS,6948,45557,null,2020-05-10 20:00:00,157,657,52505,52505,52505,20,0,22,2375,197,2572
20200507,KS,6144,38678,null,2020-05-07 20:00:00,147,587,44822,44822,44822,20,3,16,2298,410,2708
20200508,KS,6501,41207,null,2020-05-08 20:00:00,152,608,47708,47708,47708,20,5,21,2529,357,2886
20200306,KS,0,4,0,2020-03-06 21:00:00,null,null,4,4,4,20,null,null,null,null,null
20200511,KY,6440,80483,null,2020-05-11 20:00:00,304,1757,86923,86923,86923,21,0,0,0,0,0
20200503,KY,4879,52770,null,2020-05-03 20:00:00,248,1411,57649,57649,57649,21,0,0,0,0,0
20200411,KY,1693,22595,null,2020-04-11 20:00:00,90,459,24288,24288,24288,21,0,0,0,0,0
20200315,KY,16,139,null,2020-03-15 20:00:00,null,null,155,155,155,21,0,0,0,2,2
20200307,KY,1,9,null,2020-03-07 21:00:00,null,null,10,10,10,21,0,0,2,1,3
20200308,KY,1,13,null,2020-03-08 20:00:00,null,null,14,14,14,21,0,0,4,0,4
20200309,KY,4,17,null,2020-03-09 20:00:00,null,null,21,21,21,21,0,0,4,3,7
20200312,KY,8,56,null,2020-03-12 20:00:00,null,null,64,64,64,21,0,0,10,0,10
20200310,KY,6,28,null,2020-03-10 20:00:00,null,null,34,34,34,21,0,0,11,2,13
20200324,KY,124,1762,null,2020-03-24 20:00:00,4,null,1886,1886,1886,21,1,0,0,20,20
20200311,KY,8,46,null,2020-03-11 20:00:00,null,null,54,54,54,21,0,0,18,2,20
20200314,KY,14,139,null,2020-03-14 20:00:00,null,null,153,153,153,21,0,0,32,3,35
20200313,KY,11,107,null,2020-03-13 20:00:00,null,null,118,118,118,21,0,0,51,3,54
20200317,KY,22,295,null,2020-03-17 20:00:00,1,null,317,317,317,21,0,0,61,1,62
20200318,KY,26,354,null,2020-03-18 20:00:00,1,null,380,380,380,21,0,0,59,4,63
20200316,KY,21,234,null,2020-03-16 20:00:00,1,null,255,255,255,21,1,0,95,5,100
20200319,KY,35,454,null,2020-03-19 20:00:00,1,null,489,489,489,21,0,0,100,9,109
20200321,KY,54,714,null,2020-03-21 20:00:00,2,null,768,768,768,21,1,0,122,7,129
20200320,KY,47,592,null,2020-03-20 20:00:00,1,null,639,639,639,21,0,0,138,12,150
20200409,KY,1346,20455,null,2020-04-09 20:00:00,73,null,21801,21801,21801,21,8,0,0,197,197
20200421,KY,3050,29770,null,2020-04-21 20:00:00,154,1059,32820,32820,32820,21,6,0,158,90,248
20200326,KY,198,3102,null,2020-03-26 20:00:00,4,null,3300,3300,3300,21,0,0,237,41,278
20200412,KY,1840,22727,null,2020-04-12 20:00:00,94,459,24567,24567,24567,21,4,0,132,147,279
20200323,KY,104,1762,null,2020-03-23 20:00:00,3,null,1866,1866,1866,21,0,0,290,5,295
20200428,KY,4146,44653,null,2020-04-28 20:00:00,213,1281,48799,48799,48799,21,5,7,253,72,325
20200402,KY,680,7220,null,2020-04-02 20:00:00,20,null,7900,7900,7900,21,3,0,255,89,344
20200420,KY,2960,29612,null,2020-04-20 20:00:00,148,1059,32572,32572,32572,21,4,0,94,253,347
20200329,KY,394,5147,null,2020-03-29 20:00:00,9,null,5541,5541,5541,21,1,0,326,92,418
20200510,KY,6440,80483,null,2020-05-10 20:00:00,304,1757,86923,86923,86923,21,6,61,324,152,476
20200330,KY,439,5579,null,2020-03-30 20:00:00,9,null,6018,6018,6018,21,0,0,432,45,477
20200422,KY,3192,30136,null,2020-04-22 20:00:00,171,1076,33328,33328,33328,21,17,17,366,142,508
20200416,KY,2291,26033,null,2020-04-16 20:00:00,122,807,28324,28324,28324,21,7,120,546,81,627
20200327,KY,248,3768,null,2020-03-27 20:00:00,6,null,4016,4016,4016,21,2,0,666,50,716
20200401,KY,591,6965,null,2020-04-01 20:00:00,17,null,7556,7556,7556,21,6,0,635,111,746
20200504,KY,5130,53279,null,2020-05-04 20:00:00,253,1519,58409,58409,58409,21,5,108,509,251,760
20200331,KY,480,6330,null,2020-03-31 20:00:00,11,null,6810,6810,6810,21,2,0,751,41,792
20200322,KY,99,1472,null,2020-03-22 20:00:00,3,null,1571,1571,1571,21,1,0,758,45,803
20200414,KY,2048,24635,null,2020-04-14 20:00:00,104,673,26683,26683,26683,21,7,6,732,85,817
20200418,KY,2522,28074,null,2020-04-18 20:00:00,137,1008,30596,30596,30596,21,8,37,756,93,849
20200506,KY,5822,55192,null,2020-05-06 20:00:00,275,1603,61014,61014,61014,21,14,74,390,577,967
20200415,KY,2210,25487,null,2020-04-15 20:00:00,115,687,27697,27697,27697,21,11,14,852,162,1014
20200502,KY,4879,52770,null,2020-05-02 20:00:00,248,1411,57649,57649,57649,21,8,36,866,171,1037
20200405,KY,917,15746,null,2020-04-05 20:00:00,40,null,16663,16663,16663,21,3,0,1005,86,1091
20200328,KY,302,4821,null,2020-03-28 20:00:00,8,null,5123,5123,5123,21,2,0,1053,54,1107
20200325,KY,157,2865,null,2020-03-25 20:00:00,4,null,3022,3022,3022,21,0,0,1103,33,1136
20200407,KY,1008,18947,null,2020-04-07 20:00:00,59,null,19955,19955,19955,21,14,0,1135,53,1188
20200413,KY,1963,23903,null,2020-04-13 20:00:00,97,667,25866,25866,25866,21,3,208,1176,123,1299
20200417,KY,2429,27318,null,2020-04-17 20:00:00,129,971,29747,29747,29747,21,7,164,1285,138,1423
20200426,KY,3905,42653,null,2020-04-26 20:00:00,205,1266,46558,46558,46558,21,5,123,1470,126,1596
20200419,KY,2707,29518,null,2020-04-19 20:00:00,144,1059,32225,32225,32225,21,7,51,1444,185,1629
20200505,KY,5245,54802,null,2020-05-05 20:00:00,261,1529,60047,60047,60047,21,8,10,1523,115,1638
20200408,KY,1149,20455,null,2020-04-08 20:00:00,65,null,21604,21604,21604,21,6,0,1508,141,1649
20200430,KY,4539,49562,null,2020-04-30 20:00:00,235,1359,54101,54101,54101,21,10,28,1526,164,1690
20200427,KY,4074,44400,null,2020-04-27 20:00:00,208,1274,48474,48474,48474,21,3,8,1747,169,1916
20200406,KY,955,17812,null,2020-04-06 20:00:00,45,null,18767,18767,18767,21,5,0,2066,38,2104
20200425,KY,3779,41183,null,2020-04-25 20:00:00,200,1143,44962,44962,44962,21,9,28,1820,298,2118
20200410,KY,1693,22595,null,2020-04-10 20:00:00,90,459,24288,24288,24288,21,17,459,2140,347,2487
20200501,KY,4708,51904,null,2020-05-01 20:00:00,240,1375,56612,56612,56612,21,5,16,2342,169,2511
20200423,KY,3373,32702,null,2020-04-23 20:00:00,185,1105,36075,36075,36075,21,14,29,2566,181,2747
20200404,KY,831,14741,null,2020-04-04 20:00:00,37,null,15572,15572,15572,21,6,0,2707,61,2768
20200508,KY,6129,75272,null,2020-05-08 20:00:00,294,1684,81401,81401,81401,21,11,68,2600,195,2795
20200429,KY,4375,48036,null,2020-04-29 20:00:00,225,1331,52411,52411,52411,21,12,50,3383,229,3612
20200403,KY,770,12034,null,2020-04-03 20:00:00,31,null,12804,12804,12804,21,11,0,4814,90,4904
20200509,KY,6288,80159,null,2020-05-09 20:00:00,298,1696,86447,86447,86447,21,4,12,4887,159,5046
20200424,KY,3481,39363,null,2020-04-24 20:00:00,191,1115,42844,42844,42844,21,6,10,6661,108,6769
20200507,KY,5934,72672,null,2020-05-07 20:00:00,283,1616,78606,78606,78606,21,8,13,17480,112,17592
20200306,KY,0,7,3,2020-03-06 21:00:00,null,null,10,7,7,21,null,null,null,null,null
20200419,LA,23928,111420,null,2020-04-19 20:00:00,1296,null,135348,135348,135348,22,29,0,-2999,348,-2651
20200309,LA,1,5,null,2020-03-09 20:00:00,null,null,6,6,6,22,0,0,0,1,1
20200308,LA,0,5,null,2020-03-08 20:00:00,null,null,5,5,5,22,0,0,5,0,5
20200310,LA,1,11,null,2020-03-10 20:00:00,null,null,12,12,12,22,0,0,6,0,6
20200312,LA,14,37,null,2020-03-12 20:00:00,null,null,51,51,51,22,0,0,0,8,8
20200313,LA,36,37,null,2020-03-13 20:00:00,null,null,73,73,73,22,0,0,0,22,22
20200311,LA,6,37,null,2020-03-11 20:00:00,null,null,43,43,43,22,0,0,26,5,31
20200316,LA,115,188,null,2020-03-16 20:00:00,2,null,303,303,303,22,0,0,32,25,57
20200315,LA,90,156,null,2020-03-15 20:00:00,2,null,246,246,246,22,2,0,47,39,86
20200314,LA,51,109,null,2020-03-14 20:00:00,null,null,160,160,160,22,0,0,72,15,87
20200317,LA,137,286,null,2020-03-17 20:00:00,4,null,423,423,423,22,2,0,98,22,120
20200318,LA,240,335,null,2020-03-18 20:00:00,6,null,575,575,575,22,2,0,49,103,152
20200319,LA,347,458,null,2020-03-19 20:00:00,8,null,805,805,805,22,2,0,123,107,230
20200320,LA,473,568,null,2020-03-20 20:00:00,12,null,1041,1041,1041,22,4,0,110,126,236
20200421,LA,24854,111588,null,2020-04-21 20:00:00,1405,null,136442,136442,136442,22,77,0,0,331,331
20200422,LA,25258,111588,null,2020-04-22 20:00:00,1473,null,136846,136846,136846,22,68,0,0,404,404
20200424,LA,26140,111972,null,2020-04-24 20:00:00,1601,null,138112,138112,138112,22,61,0,198,401,599
20200423,LA,25739,111774,null,2020-04-23 20:00:00,1540,null,137513,137513,137513,22,67,0,186,481,667
20200322,LA,837,2661,null,2020-03-22 20:00:00,20,null,3498,3498,3498,22,4,0,481,257,738
20200420,LA,24523,111588,null,2020-04-20 20:00:00,1328,null,136111,136111,136111,22,32,0,168,595,763
20200425,LA,26512,112490,null,2020-04-25 20:00:00,1644,null,139002,139002,139002,22,43,0,518,372,890
20200508,LA,30855,171561,null,2020-05-08 20:00:00,2227,null,202416,202416,202416,22,19,0,1446,203,1649
20200321,LA,580,2180,null,2020-03-21 20:00:00,16,null,2760,2760,2760,22,4,0,1612,107,1719
20200405,LA,13010,47315,null,2020-04-05 20:00:00,477,null,60325,60325,60325,22,68,0,1313,514,1827
20200323,LA,1172,4776,null,2020-03-23 20:00:00,34,null,5948,5948,5948,22,14,0,2115,335,2450
20200403,LA,10297,43348,null,2020-04-03 20:00:00,370,null,53645,53645,53645,22,60,0,1412,1147,2559
20200324,LA,1388,7215,null,2020-03-24 20:00:00,46,null,8603,8603,8603,22,12,0,2439,216,2655
20200329,LA,3540,24331,null,2020-03-29 20:00:00,151,null,27871,27871,27871,22,14,0,2485,225,2710
20200325,LA,1795,9656,null,2020-03-25 20:00:00,65,null,11451,11451,11451,22,19,0,2441,407,2848
20200503,LA,29340,146820,null,2020-05-03 20:00:00,1969,null,176160,176160,176160,22,19,0,3102,200,3302
20200327,LA,2746,18613,null,2020-03-27 20:00:00,119,null,21359,21359,21359,22,36,0,2889,441,3330
20200415,LA,21951,99977,null,2020-04-15 20:00:00,1103,null,121928,121928,121928,22,90,0,3073,433,3506
20200510,LA,31600,184272,null,2020-05-10 20:00:00,2286,null,215872,215872,215872,22,19,0,3532,183,3715
20200328,LA,3315,21846,null,2020-03-28 20:00:00,137,null,25161,25161,25161,22,18,0,3233,569,3802
20200427,LA,27068,119921,null,2020-04-27 20:00:00,1697,null,146989,146989,146989,22,27,0,3658,295,3953
20200426,LA,26773,116263,null,2020-04-26 20:00:00,1670,null,143036,143036,143036,22,26,0,3773,261,4034
20200413,LA,21016,87075,null,2020-04-13 20:00:00,884,null,108091,108091,108091,22,44,0,3625,421,4046
20200428,LA,27286,123822,null,2020-04-28 20:00:00,1758,null,151108,151108,151108,22,61,0,3901,218,4119
20200502,LA,29140,143718,null,2020-05-02 20:00:00,1950,null,172858,172858,172858,22,23,0,4178,429,4607
20200411,LA,20014,76901,null,2020-04-11 20:00:00,806,null,96915,96915,96915,22,51,0,3874,761,4635
20200416,LA,22532,104054,null,2020-04-16 20:00:00,1156,null,126586,126586,126586,22,53,0,4077,581,4658
20200430,LA,28001,133308,null,2020-04-30 20:00:00,1862,null,161309,161309,161309,22,60,0,4400,341,4741
20200504,LA,29673,151258,null,2020-05-04 20:00:00,2064,null,180931,180931,180931,22,95,0,4438,333,4771
20200404,LA,12496,46002,null,2020-04-04 20:00:00,409,null,58498,58498,58498,22,39,0,2654,2199,4853
20200331,LA,5237,33730,null,2020-03-31 20:00:00,239,null,38967,38967,38967,22,54,0,3722,1212,4934
20200511,LA,31815,189015,null,2020-05-11 20:00:00,2308,null,220830,220830,220830,22,22,0,4743,215,4958
20200402,LA,9150,41936,null,2020-04-02 20:00:00,310,null,51086,51086,51086,22,37,0,2584,2726,5310
20200410,LA,19253,73027,null,2020-04-10 20:00:00,755,null,92280,92280,92280,22,53,0,4391,970,5361
20200417,LA,23118,108869,null,2020-04-17 20:00:00,1213,null,131987,131987,131987,22,57,0,4815,586,5401
20200429,LA,27660,128908,null,2020-04-29 20:00:00,1802,null,156568,156568,156568,22,44,0,5086,374,5460
20200407,LA,16284,58371,null,2020-04-07 20:00:00,582,null,74655,74655,74655,22,70,0,4072,1417,5489
20200409,LA,18283,68636,null,2020-04-09 20:00:00,702,null,86919,86919,86919,22,50,0,4260,1253,5513
20200418,LA,23580,114419,null,2020-04-18 20:00:00,1267,null,137999,137999,137999,22,54,0,5550,462,6012
20200507,LA,30652,170115,null,2020-05-07 20:00:00,2208,null,200767,200767,200767,22,93,0,5842,253,6095
20200330,LA,4025,30008,null,2020-03-30 20:00:00,185,null,34033,34033,34033,22,34,0,5677,485,6162
20200506,LA,30399,164273,null,2020-05-06 20:00:00,2115,null,194672,194672,194672,22,0,0,6038,403,6441
20200326,LA,2305,15724,null,2020-03-26 20:00:00,83,null,18029,18029,18029,22,18,0,6068,510,6578
20200408,LA,17030,64376,null,2020-04-08 20:00:00,652,null,81406,81406,81406,22,70,0,6005,746,6751
20200401,LA,6424,39352,null,2020-04-01 20:00:00,273,null,45776,45776,45776,22,34,0,5622,1187,6809
20200501,LA,28711,139540,null,2020-05-01 20:00:00,1927,null,168251,168251,168251,22,65,0,6232,710,6942
20200412,LA,20595,83450,null,2020-04-12 20:00:00,840,null,104045,104045,104045,22,34,0,6549,581,7130
20200505,LA,29996,158235,null,2020-05-05 20:00:00,2115,null,188231,188231,188231,22,51,0,6977,323,7300
20200406,LA,14867,54299,null,2020-04-06 20:00:00,512,null,69166,69166,69166,22,35,0,6984,1857,8841
20200509,LA,31417,180740,null,2020-05-09 20:00:00,2267,null,212157,212157,212157,22,40,0,9179,562,9741
20200414,LA,21518,96904,null,2020-04-14 20:00:00,1013,null,118422,118422,118422,22,129,0,9829,502,10331
20200307,LA,0,null,null,2020-03-07 21:00:00,null,null,0,0,0,22,null,null,null,null,null
20200314,MA,38,null,null,2020-03-14 20:00:00,null,null,38,38,38,25,0,0,0,15,15
20200313,MA,23,null,null,2020-03-13 20:00:00,null,null,23,23,23,25,0,0,0,15,15
20200317,MA,118,1633,null,2020-03-17 20:00:00,null,null,1751,1751,1751,25,0,0,434,21,455
20200318,MA,156,2115,null,2020-03-18 20:00:00,2,null,2271,2271,2271,25,2,0,482,38,520
20200315,MA,64,584,null,2020-03-15 20:00:00,null,null,648,648,648,25,0,0,584,26,610
20200316,MA,97,1199,null,2020-03-16 20:00:00,null,null,1296,1296,1296,25,0,0,615,33,648
20200322,MA,547,5476,null,2020-03-22 20:00:00,11,71,6023,6023,6023,25,4,10,677,121,798
20200319,MA,229,2918,null,2020-03-19 20:00:00,3,null,3147,3147,3147,25,1,0,803,73,876
20200320,MA,314,3795,null,2020-03-20 20:00:00,5,null,4109,4109,4109,25,2,0,877,85,962
20200321,MA,426,4799,null,2020-03-21 20:00:00,7,61,5225,5225,5225,25,2,61,1004,112,1116
20200323,MA,678,8263,null,2020-03-23 20:00:00,17,79,8941,8941,8941,25,6,8,2787,131,2918
20200405,MA,12402,59565,null,2020-04-05 20:00:00,370,1632,71967,71967,71967,25,66,262,2374,765,3139
20200330,MA,5653,37166,null,2020-03-30 20:00:00,124,453,42819,42819,42819,25,25,54,2932,797,3729
20200326,MA,2318,21327,null,2020-03-26 20:00:00,42,219,23645,23645,23645,25,9,116,3248,579,3827
20200329,MA,4856,34234,null,2020-03-29 20:00:00,99,399,39090,39090,39090,25,27,49,3319,698,4017
20200331,MA,6521,40440,null,2020-03-31 20:00:00,153,562,46961,46961,46961,25,29,109,3274,868,4142
20200406,MA,13739,62720,null,2020-04-06 20:00:00,448,1667,76459,76459,76459,25,78,35,3155,1337,4492
20200414,MA,28109,98820,null,2020-04-14 20:00:00,1329,3616,126929,126929,126929,25,118,131,3320,1315,4635
20200401,MA,7639,44125,null,2020-04-01 20:00:00,187,682,51764,51764,51764,25,34,120,3685,1118,4803
20200324,MA,1060,12714,null,2020-03-24 20:00:00,26,94,13774,13774,13774,25,9,15,4451,382,4833
20200402,MA,8867,47767,null,2020-04-02 20:00:00,229,813,56634,56634,56634,25,42,131,3642,1228,4870
20200407,MA,15104,66270,null,2020-04-07 20:00:00,515,1831,81374,81374,81374,25,67,164,3550,1365,4915
20200422,MA,44913,144789,null,2020-04-22 20:00:00,2597,4256,189702,189702,189702,25,148,247,3345,1745,5090
20200413,MA,26794,95500,null,2020-04-13 20:00:00,1211,3485,122294,122294,122294,25,155,971,4037,1413,5450
20200328,MA,4158,30915,null,2020-03-28 20:00:00,72,350,35073,35073,35073,25,15,131,4671,1007,5678
20200327,MA,3151,26244,null,2020-03-27 20:00:00,57,219,29395,29395,29395,25,15,0,4917,833,5750
20200415,MA,29970,102790,null,2020-04-15 20:00:00,1502,3637,132760,132760,132760,25,173,21,3970,1861,5831
20200404,MA,11637,57191,null,2020-04-04 20:00:00,304,1370,68828,68828,68828,25,39,404,4506,1334,5840
20200325,MA,1739,18079,null,2020-03-25 20:00:00,33,103,19818,19818,19818,25,7,9,5365,679,6044
20200408,MA,16692,70849,null,2020-04-08 20:00:00,615,2119,87541,87541,87541,25,100,288,4579,1588,6167
20200506,MA,72025,267614,null,2020-05-06 20:00:00,4420,7080,339639,339639,339639,25,208,249,4536,1754,6290
20200511,MA,78462,316266,null,2020-05-11 20:00:00,5108,7732,394728,394728,394728,25,129,115,5670,669,6339
20200403,MA,10303,52685,null,2020-04-03 20:00:00,265,966,62988,62988,62988,25,36,153,4918,1436,6354
20200411,MA,22766,86115,null,2020-04-11 20:00:00,946,2507,108881,108881,108881,25,114,72,4551,1888,6439
20200419,MA,39820,129295,null,2020-04-19 20:00:00,2146,3789,169115,169115,169115,25,163,61,4691,2293,6984
20200421,MA,43168,141444,null,2020-04-21 20:00:00,2449,4009,184612,184612,184612,25,146,137,5398,1752,7150
20200409,MA,18843,76146,null,2020-04-09 20:00:00,725,2302,94989,94989,94989,25,110,183,5297,2151,7448
20200410,MA,20878,81564,null,2020-04-10 20:00:00,832,2435,102442,102442,102442,25,107,133,5418,2035,7453
20200412,MA,25381,91463,null,2020-04-12 20:00:00,1056,2514,116844,116844,116844,25,110,7,5348,2615,7963
20200420,MA,41416,136046,null,2020-04-20 20:00:00,2303,3872,177462,177462,177462,25,157,83,6751,1596,8347
20200427,MA,56462,188425,null,2020-04-27 20:00:00,3003,5237,244887,244887,244887,25,104,133,7263,1524,8787
20200505,MA,70271,263078,null,2020-05-05 20:00:00,4212,6831,333349,333349,333349,25,122,209,7897,1184,9081
20200426,MA,54938,181162,null,2020-04-26 20:00:00,2899,5104,236100,236100,236100,25,22,139,7665,1590,9255
20200502,MA,66263,232731,null,2020-05-02 20:00:00,3846,6378,298994,298994,298994,25,130,209,7406,1952,9358
20200428,MA,58302,196198,null,2020-04-28 20:00:00,3153,5515,254500,254500,254500,25,150,278,7773,1840,9613
20200504,MA,69087,255181,null,2020-05-04 20:00:00,4090,6622,324268,324268,324268,25,86,115,8622,1000,9622
20200417,MA,35125,117195,null,2020-04-17 20:00:00,1822,3756,152320,152320,152320,25,155,30,7097,2633,9730
20200418,MA,37527,124604,null,2020-04-18 20:00:00,1983,3728,162131,162131,162131,25,161,-28,7409,2402,9811
20200416,MA,32492,110098,null,2020-04-16 20:00:00,1667,3726,142590,142590,142590,25,165,89,7308,2522,9830
20200430,MA,62205,213442,null,2020-04-30 20:00:00,3562,5942,275647,275647,275647,25,157,184,8089,1940,10029
20200509,MA,76743,299794,null,2020-05-09 20:00:00,4840,7551,376537,376537,376537,25,138,117,9104,1410,10514
20200424,MA,50969,164244,null,2020-04-24 20:00:00,2877,4752,215213,215213,215213,25,108,259,7920,2977,10897
20200429,MA,60265,205353,null,2020-04-29 20:00:00,3405,5758,265618,265618,265618,25,252,243,9155,1963,11118
20200425,MA,53348,173497,null,2020-04-25 20:00:00,2877,4965,226845,226845,226845,25,0,213,9253,2379,11632
20200510,MA,77793,310596,null,2020-05-10 20:00:00,4979,7617,388389,388389,388389,25,139,66,10802,1050,11852
20200507,MA,73721,277911,null,2020-05-07 20:00:00,4552,7237,351632,351632,351632,25,132,157,10297,1696,11993
20200501,MA,64311,225325,null,2020-05-01 20:00:00,3716,6169,289636,289636,289636,25,154,227,11883,2106,13989
20200508,MA,75333,290690,null,2020-05-08 20:00:00,4702,7434,366023,366023,366023,25,150,197,12779,1612,14391
20200423,MA,47992,156324,null,2020-04-23 20:00:00,2769,4493,204316,204316,204316,25,172,237,11535,3079,14614
20200503,MA,68087,246559,null,2020-05-03 20:00:00,4004,6507,314646,314646,314646,25,158,129,13828,1824,15652
20200312,MA,8,null,null,2020-03-12 20:00:00,null,null,8,8,8,25,null,null,null,null,null
20200312,MD,12,94,null,2020-03-12 20:00:00,null,null,106,106,106,24,0,0,0,3,3
20200315,MD,31,94,null,2020-03-15 20:00:00,null,null,125,125,125,24,0,0,0,5,5
20200313,MD,17,94,null,2020-03-13 20:00:00,null,null,111,111,111,24,0,0,0,5,5
20200316,MD,37,94,null,2020-03-16 20:00:00,null,null,131,131,131,24,0,0,0,6,6
20200311,MD,9,94,null,2020-03-11 20:00:00,null,null,103,103,103,24,0,0,5,3,8
20200314,MD,26,94,null,2020-03-14 20:00:00,null,null,120,120,120,24,0,0,0,9,9
20200308,MD,3,52,null,2020-03-08 20:00:00,null,null,55,55,55,24,0,0,11,0,11
20200306,MD,3,26,12,2020-03-06 21:00:00,null,null,41,29,29,24,0,0,9,3,12
20200307,MD,3,41,null,2020-03-07 21:00:00,null,null,44,44,44,24,0,0,15,0,15
20200310,MD,6,89,null,2020-03-10 20:00:00,null,null,95,95,95,24,0,0,16,1,17
20200317,MD,57,94,null,2020-03-17 20:00:00,null,null,151,151,151,24,0,0,0,20,20
20200319,MD,107,94,null,2020-03-19 20:00:00,1,null,201,201,201,24,1,0,0,22,22
20200309,MD,5,73,null,2020-03-09 20:00:00,null,null,78,78,78,24,0,0,21,2,23
20200318,MD,85,94,null,2020-03-18 20:00:00,null,null,179,179,179,24,0,0,0,28,28
20200321,MD,190,94,null,2020-03-21 20:00:00,2,null,284,284,284,24,1,0,0,41,41
20200320,MD,149,94,null,2020-03-20 20:00:00,1,null,243,243,243,24,0,0,0,42,42
20200323,MD,288,94,null,2020-03-23 20:00:00,3,null,382,382,382,24,0,0,0,44,44
20200322,MD,244,94,null,2020-03-22 20:00:00,3,null,338,338,338,24,1,0,0,54,54
20200324,MD,349,94,null,2020-03-24 20:00:00,3,null,443,443,443,24,0,0,0,61,61
20200325,MD,423,94,null,2020-03-25 20:00:00,4,null,517,517,517,24,1,0,0,74,74
20200326,MD,580,94,null,2020-03-26 20:00:00,4,132,674,674,674,24,0,132,0,157,157
20200327,MD,774,94,null,2020-03-27 20:00:00,5,173,868,868,868,24,1,41,0,194,194
20200329,MD,1239,12354,null,2020-03-29 20:00:00,10,277,13593,13593,13593,24,5,51,838,247,1085
20200330,MD,1413,13316,null,2020-03-30 20:00:00,15,353,14729,14729,14729,24,5,76,962,174,1136
20200406,MD,4045,25572,null,2020-04-06 20:00:00,91,1059,29617,29617,29617,24,24,123,844,436,1280
20200331,MD,1660,14868,null,2020-03-31 20:00:00,18,429,16528,16528,16528,24,3,76,1552,247,1799
20200404,MD,3125,22485,null,2020-04-04 20:00:00,53,821,25610,25610,25610,24,11,157,1553,367,1920
20200414,MD,9472,44261,null,2020-04-14 20:00:00,302,2122,53733,53733,53733,24,40,147,1446,536,1982
20200413,MD,8936,42815,null,2020-04-13 20:00:00,262,1975,51751,51751,51751,24,27,115,1276,711,1987
20200402,MD,2331,18890,null,2020-04-02 20:00:00,36,582,21221,21221,21221,24,5,60,1657,346,2003
20200407,MD,4371,27256,null,2020-04-07 20:00:00,103,1106,31627,31627,31627,24,12,47,1684,326,2010
20200415,MD,10032,45731,null,2020-04-15 20:00:00,413,2231,55763,55763,55763,24,111,109,1470,560,2030
20200421,MD,14193,59442,null,2020-04-21 20:00:00,652,3158,73635,73635,73635,24,70,144,1729,509,2238
20200403,MD,2758,20932,null,2020-04-03 20:00:00,42,664,23690,23690,23690,24,6,82,2042,427,2469
20200419,MD,12830,55061,null,2020-04-19 20:00:00,548,2886,67891,67891,67891,24,14,129,1999,522,2521
20200412,MD,8225,41539,null,2020-04-12 20:00:00,235,1860,49764,49764,49764,24,29,151,1995,531,2526
20200401,MD,1985,17233,null,2020-04-01 20:00:00,31,522,19218,19218,19218,24,13,93,2365,325,2690
20200405,MD,3609,24728,null,2020-04-05 20:00:00,67,936,28337,28337,28337,24,14,115,2243,484,2727
20200411,MD,7694,39544,null,2020-04-11 20:00:00,206,1709,47238,47238,47238,24,35,296,2064,726,2790
20200428,MD,20113,87672,null,2020-04-28 20:00:00,1016,4268,107785,107785,107785,24,71,167,2183,626,2809
20200422,MD,14775,61754,null,2020-04-22 20:00:00,698,3325,76529,76529,76529,24,46,167,2312,582,2894
20200410,MD,6968,37480,null,2020-04-10 20:00:00,171,1413,44448,44448,44448,24,33,65,2136,783,2919
20200409,MD,6185,35344,null,2020-04-09 20:00:00,138,1348,41529,41529,41529,24,14,138,2411,656,3067
20200416,MD,10784,48059,null,2020-04-16 20:00:00,459,2451,58843,58843,58843,24,46,220,2328,752,3080
20200505,MD,27117,112986,null,2020-05-05 20:00:00,1390,5337,140103,140103,140103,24,73,138,2399,709,3108
20200429,MD,20849,90080,null,2020-04-29 20:00:00,1078,4402,110929,110929,110929,24,62,134,2408,736,3144
20200417,MD,11572,50437,null,2020-04-17 20:00:00,494,2612,62009,62009,62009,24,35,161,2378,788,3166
20200418,MD,12308,53062,null,2020-04-18 20:00:00,534,2757,65370,65370,65370,24,40,145,2625,736,3361
20200430,MD,21742,92617,null,2020-04-30 20:00:00,1140,4559,114359,114359,114359,24,62,157,2537,893,3430
20200420,MD,13684,57713,null,2020-04-20 20:00:00,582,3014,71397,71397,71397,24,34,128,2652,854,3506
20200423,MD,15737,64363,null,2020-04-23 20:00:00,748,3477,80100,80100,80100,24,50,152,2609,962,3571
20200508,MD,30485,121702,null,2020-05-08 20:00:00,1560,5811,152187,152187,152187,24,57,148,2476,1111,3587
20200509,MD,31534,124494,null,2020-05-09 20:00:00,1614,5932,156028,156028,156028,24,54,121,2792,1049,3841
20200510,MD,32587,127344,null,2020-05-10 20:00:00,1644,5955,159931,159931,159931,24,30,23,2850,1053,3903
20200506,MD,28163,115849,null,2020-05-06 20:00:00,1437,5497,144012,144012,144012,24,47,160,2863,1046,3909
20200504,MD,26408,110587,null,2020-05-04 20:00:00,1317,5199,136995,136995,136995,24,36,148,3255,946,4201
20200425,MD,17766,71357,null,2020-04-25 20:00:00,875,3760,89123,89123,89123,24,77,142,3257,1150,4407
20200502,MD,24473,101049,null,2020-05-02 20:00:00,1251,4910,125522,125522,125522,24,59,192,3538,1001,4539
20200507,MD,29374,119226,null,2020-05-07 20:00:00,1503,5663,148600,148600,148600,24,66,166,3377,1211,4588
20200424,MD,16616,68100,null,2020-04-24 20:00:00,798,3618,84716,84716,84716,24,50,141,3737,879,4616
20200511,MD,33373,131407,null,2020-05-11 20:00:00,1683,6183,164780,164780,164780,24,39,228,4063,786,4849
20200501,MD,23472,97511,null,2020-05-01 20:00:00,1192,4718,120983,120983,120983,24,52,159,4894,1730,6624
20200408,MD,5529,32933,null,2020-04-08 20:00:00,124,1210,38462,38462,38462,24,21,104,5677,1158,6835
20200503,MD,25462,107332,null,2020-05-03 20:00:00,1281,5051,132794,132794,132794,24,30,141,6283,989,7272
20200426,MD,18581,78084,null,2020-04-26 20:00:00,910,3962,96665,96665,96665,24,35,202,6727,815,7542
20200427,MD,19487,85489,null,2020-04-27 20:00:00,945,4101,104976,104976,104976,24,35,139,7405,906,8311
20200328,MD,992,11516,null,2020-03-28 20:00:00,5,226,12508,12508,12508,24,0,53,11422,218,11640
20200305,MD,0,17,14,2020-03-05 21:00:00,null,null,31,17,17,24,null,null,null,null,null
20200315,ME,3,91,17,2020-03-15 20:00:00,null,null,111,94,94,23,0,0,0,0,0
20200314,ME,3,91,17,2020-03-14 20:00:00,null,null,111,94,94,23,0,0,0,0,0
20200309,ME,0,1,null,2020-03-09 20:00:00,null,null,1,1,1,23,0,0,0,0,0
20200308,ME,0,1,null,2020-03-08 20:00:00,null,null,1,1,1,23,0,0,0,0,0
20200427,ME,1023,16784,null,2020-04-27 20:00:00,51,161,17807,17807,17807,23,1,2,0,8,8
20200420,ME,875,14076,null,2020-04-20 20:00:00,35,138,14951,14951,14951,23,1,2,0,8,8
20200421,ME,888,14076,null,2020-04-21 20:00:00,36,139,14964,14964,14964,23,1,1,0,13,13
20200327,ME,168,3394,null,2020-03-27 20:00:00,1,null,3562,3562,3562,23,1,0,0,13,13
20200405,ME,470,6088,null,2020-04-05 20:00:00,10,86,6558,6558,6558,23,0,3,0,14,14
20200322,ME,89,2264,null,2020-03-22 20:00:00,null,null,2353,2353,2353,23,0,0,0,16,16
20200321,ME,73,2264,null,2020-03-21 20:00:00,null,null,2337,2337,2337,23,0,0,0,16,16
20200428,ME,1040,16784,null,2020-04-28 20:00:00,51,163,17824,17824,17824,23,0,2,0,17,17
20200412,ME,633,6088,null,2020-04-12 20:00:00,19,120,6721,6721,6721,23,0,6,0,17,17
20200408,ME,537,6088,null,2020-04-08 20:00:00,14,101,6625,6625,6625,23,2,2,0,18,18
20200310,ME,0,20,5,2020-03-10 20:00:00,null,null,25,20,20,23,0,0,19,0,19
20200504,ME,1205,19546,null,2020-05-04 20:00:00,57,186,20751,20751,20751,23,0,3,0,20,20
20200419,ME,867,14076,null,2020-04-19 20:00:00,34,136,14943,14943,14943,23,2,0,0,20,20
20200418,ME,847,14076,null,2020-04-18 20:00:00,32,136,14923,14923,14923,23,3,3,0,20,20
20200407,ME,519,6088,null,2020-04-07 20:00:00,12,99,6607,6607,6607,23,2,7,0,20,20
20200505,ME,1226,19546,null,2020-05-05 20:00:00,61,187,20772,20772,20772,23,4,1,0,21,21
20200330,ME,275,3394,null,2020-03-30 20:00:00,3,49,3669,3669,3669,23,0,49,0,22,22
20200311,ME,0,42,5,2020-03-11 20:00:00,null,null,47,42,42,23,0,0,22,0,22
20200409,ME,560,6088,null,2020-04-09 20:00:00,16,105,6648,6648,6648,23,2,4,0,23,23
20200404,ME,456,6088,null,2020-04-04 20:00:00,10,83,6544,6544,6544,23,1,8,0,24,24
20200312,ME,1,65,20,2020-03-12 20:00:00,null,null,86,66,66,23,0,0,23,1,24
20200426,ME,1015,16784,null,2020-04-26 20:00:00,50,159,17799,17799,17799,23,0,3,0,25,25
20200425,ME,990,16784,null,2020-04-25 20:00:00,50,156,17774,17774,17774,23,3,4,0,25,25
20200511,ME,1462,22092,null,2020-05-11 20:00:00,65,200,23554,23554,23554,23,1,1,0,26,26
20200416,ME,796,14076,null,2020-04-16 20:00:00,27,130,14872,14872,14872,23,3,4,0,26,26
20200410,ME,586,6088,null,2020-04-10 20:00:00,17,111,6674,6674,6674,23,1,6,0,26,26
20200510,ME,1436,22092,null,2020-05-10 20:00:00,64,199,23528,23528,23528,23,0,1,0,28,28
20200501,ME,1123,19546,null,2020-05-01 20:00:00,55,177,20669,20669,20669,23,2,7,0,28,28
20200424,ME,965,16784,null,2020-04-24 20:00:00,47,152,17749,17749,17749,23,3,2,0,28,28
20200313,ME,3,91,17,2020-03-13 20:00:00,null,null,111,94,94,23,0,0,26,2,28
20200502,ME,1152,19546,null,2020-05-02 20:00:00,56,181,20698,20698,20698,23,1,4,0,29,29
20200406,ME,499,6088,null,2020-04-06 20:00:00,10,92,6587,6587,6587,23,0,6,0,29,29
20200423,ME,937,16784,null,2020-04-23 20:00:00,44,150,17721,17721,17721,23,5,6,0,30,30
20200411,ME,616,6088,null,2020-04-11 20:00:00,19,114,6704,6704,6704,23,2,3,0,30,30
20200417,ME,827,14076,null,2020-04-17 20:00:00,29,133,14903,14903,14903,23,2,3,0,31,31
20200402,ME,376,6088,null,2020-04-02 20:00:00,7,68,6464,6464,6464,23,0,5,0,32,32
20200503,ME,1185,19546,null,2020-05-03 20:00:00,57,183,20731,20731,20731,23,1,2,0,33,33
20200509,ME,1408,22092,null,2020-05-09 20:00:00,64,198,23500,23500,23500,23,1,4,0,34,34
20200414,ME,734,11608,null,2020-04-14 20:00:00,20,124,12342,12342,12342,23,1,0,0,36,36
20200430,ME,1095,19546,null,2020-04-30 20:00:00,53,170,20641,20641,20641,23,1,4,0,39,39
20200401,ME,344,6088,null,2020-04-01 20:00:00,7,63,6432,6432,6432,23,2,6,0,41,41
20200329,ME,253,3394,null,2020-03-29 20:00:00,3,null,3647,3647,3647,23,2,0,0,42,42
20200328,ME,211,3394,null,2020-03-28 20:00:00,1,null,3605,3605,3605,23,0,0,0,43,43
20200508,ME,1374,22092,null,2020-05-08 20:00:00,63,194,23466,23466,23466,23,1,2,0,44,44
20200403,ME,432,6088,null,2020-04-03 20:00:00,9,75,6520,6520,6520,23,2,7,0,56,56
20200507,ME,1330,22092,null,2020-05-07 20:00:00,62,192,23422,23422,23422,23,0,1,0,76,76
20200325,ME,149,3177,null,2020-03-25 20:00:00,null,null,3326,3326,3326,23,0,0,163,24,187
20200326,ME,155,3394,null,2020-03-26 20:00:00,null,null,3549,3549,3549,23,0,0,217,6,223
20200324,ME,125,3014,null,2020-03-24 20:00:00,null,null,3139,3139,3139,23,0,0,223,18,241
20200320,ME,57,2264,null,2020-03-20 20:00:00,null,null,2321,2321,2321,23,0,0,260,4,264
20200319,ME,53,2004,null,2020-03-19 20:00:00,null,null,2057,2057,2057,23,0,0,334,10,344
20200318,ME,43,1670,null,2020-03-18 20:00:00,null,null,1713,1713,1713,23,0,0,367,11,378
20200323,ME,107,2791,null,2020-03-23 20:00:00,null,null,2898,2898,2898,23,0,0,527,18,545
20200317,ME,32,1303,null,2020-03-17 20:00:00,null,null,1335,1335,1335,23,0,0,539,15,554
20200316,ME,17,764,null,2020-03-16 20:00:00,null,null,781,781,781,23,0,0,673,14,687
20200415,ME,770,14076,null,2020-04-15 20:00:00,24,126,14846,14846,14846,23,4,2,2468,36,2504
20200506,ME,1254,22092,null,2020-05-06 20:00:00,62,191,23346,23346,23346,23,1,4,2546,28,2574
20200331,ME,303,6088,null,2020-03-31 20:00:00,5,57,6391,6391,6391,23,2,8,2694,28,2722
20200422,ME,907,16784,null,2020-04-22 20:00:00,39,144,17691,17691,17691,23,3,5,2708,19,2727
20200429,ME,1056,19546,null,2020-04-29 20:00:00,52,166,20602,20602,20602,23,1,3,2762,16,2778
20200413,ME,698,11608,null,2020-04-13 20:00:00,19,124,12306,12306,12306,23,0,4,5520,65,5585
20200307,ME,0,1,null,2020-03-07 21:00:00,null,null,1,1,1,23,null,null,null,null,null
20200302,MI,18,null,null,2020-03-02 21:00:00,null,null,18,18,18,26,0,0,0,9,9
20200303,MI,34,null,null,2020-03-03 21:00:00,null,null,34,34,34,26,0,0,0,16,16
20200304,MI,52,null,null,2020-03-04 21:00:00,null,null,52,52,52,26,0,0,0,18,18
20200306,MI,98,8,8,2020-03-06 21:00:00,null,null,114,106,106,26,0,0,0,26,26
20200305,MI,72,8,0,2020-03-05 21:00:00,null,null,80,80,80,26,0,0,8,20,28
20200307,MI,128,18,9,2020-03-07 21:00:00,null,null,155,146,146,26,0,0,10,30,40
20200308,MI,168,26,10,2020-03-08 20:00:00,null,null,204,194,194,26,0,0,8,40,48
20200309,MI,254,36,11,2020-03-09 20:00:00,null,null,301,290,290,26,0,0,10,86,96
20200310,MI,358,39,24,2020-03-10 20:00:00,null,null,421,397,397,26,0,0,3,104,107
20200311,MI,497,57,18,2020-03-11 20:00:00,null,null,572,554,554,26,0,0,18,139,157
20200312,MI,702,91,27,2020-03-12 20:00:00,null,null,820,793,793,26,0,0,34,205,239
20200315,MI,1480,205,26,2020-03-15 20:00:00,null,null,1711,1685,1685,26,0,0,0,284,284
20200313,MI,945,133,26,2020-03-13 20:00:00,null,null,1104,1078,1078,26,0,0,42,243,285
20200314,MI,1196,205,26,2020-03-14 20:00:00,null,null,1427,1401,1401,26,0,0,72,251,323
20200505,MI,44397,178439,null,2020-05-05 20:00:00,4179,null,222836,222836,222836,26,130,0,0,447,447
20200316,MI,1933,272,30,2020-03-16 20:00:00,null,null,2235,2205,2205,26,0,0,67,453,520
20200322,MI,5098,3712,null,2020-03-22 20:00:00,8,null,8810,8810,8810,26,3,0,16,555,571
20200408,MI,20589,45550,null,2020-04-08 20:00:00,959,null,66139,66139,66139,26,114,0,0,766,766
20200418,MI,30791,68936,null,2020-04-18 20:00:00,2308,null,99727,99727,99727,26,81,0,0,768,768
20200317,MI,2393,626,null,2020-03-17 20:00:00,null,null,3019,3019,3019,26,0,0,354,460,814
20200409,MI,21504,45550,null,2020-04-09 20:00:00,1076,null,67054,67054,67054,26,117,0,0,915,915
20200422,MI,33966,84259,null,2020-04-22 20:00:00,2813,null,118225,118225,118225,26,113,0,0,999,999
20200319,MI,3392,1785,null,2020-03-19 20:00:00,3,null,5177,5177,5177,26,3,0,570,479,1049
20200318,MI,2913,1215,null,2020-03-18 20:00:00,null,null,4128,4128,4128,26,0,0,589,520,1109
20200321,MI,4543,3696,null,2020-03-21 20:00:00,5,null,8239,8239,8239,26,2,0,950,516,1466
20200320,MI,4027,2746,null,2020-03-20 20:00:00,3,null,6773,6773,6773,26,0,0,961,635,1596
20200323,MI,5789,4697,null,2020-03-23 20:00:00,15,null,10486,10486,10486,26,7,0,985,691,1676
20200324,MI,6441,5796,null,2020-03-24 20:00:00,24,null,12237,12237,12237,26,9,0,1099,652,1751
20200328,MI,9287,14183,null,2020-03-28 20:00:00,92,null,23470,23470,23470,26,0,0,1544,628,2172
20200329,MI,10010,15676,null,2020-03-29 20:00:00,132,null,25686,25686,25686,26,40,0,1493,723,2216
20200325,MI,7060,7537,null,2020-03-25 20:00:00,43,null,14597,14597,14597,26,19,0,1741,619,2360
20200413,MI,25635,57009,null,2020-04-13 20:00:00,1602,null,82644,82644,82644,26,115,0,2210,997,3207
20200327,MI,8659,12639,null,2020-03-27 20:00:00,92,null,21298,21298,21298,26,32,0,2334,892,3226
20200407,MI,19823,45550,null,2020-04-07 20:00:00,845,null,65373,65373,65373,26,118,0,2430,973,3403
20200412,MI,24638,54799,null,2020-04-12 20:00:00,1487,null,79437,79437,79437,26,95,0,2778,645,3423
20200421,MI,32967,84259,null,2020-04-21 20:00:00,2700,null,117226,117226,117226,26,232,0,2461,967,3428
20200415,MI,28059,61638,null,2020-04-15 20:00:00,1921,null,89697,89697,89697,26,153,0,2413,1058,3471
20200326,MI,7767,10305,null,2020-03-26 20:00:00,60,null,18072,18072,18072,26,17,0,2768,707,3475
20200414,MI,27001,59225,null,2020-04-14 20:00:00,1768,null,86226,86226,86226,26,166,0,2216,1366,3582
20200331,MI,11875,23979,null,2020-03-31 20:00:00,259,null,35854,35854,35854,26,75,0,2796,974,3770
20200411,MI,23993,52021,null,2020-04-11 20:00:00,1392,null,76014,76014,76014,26,111,0,2760,1210,3970
20200406,MI,18850,43120,null,2020-04-06 20:00:00,727,null,61970,61970,61970,26,110,0,2789,1283,4072
20200405,MI,17567,40331,null,2020-04-05 20:00:00,617,null,57898,57898,57898,26,77,0,2926,1172,4098
20200420,MI,32000,81798,null,2020-04-20 20:00:00,2468,null,113798,113798,113798,26,77,0,3561,576,4137
20200401,MI,12888,27237,null,2020-04-01 20:00:00,337,null,40125,40125,40125,26,78,0,3258,1013,4271
20200402,MI,14117,30368,null,2020-04-02 20:00:00,417,null,44485,44485,44485,26,80,0,3131,1229,4360
20200403,MI,15252,33670,null,2020-04-03 20:00:00,479,null,48922,48922,48922,26,62,0,3302,1135,4437
20200416,MI,29263,65023,null,2020-04-16 20:00:00,2093,null,94286,94286,94286,26,172,0,3385,1204,4589
20200417,MI,30023,68936,null,2020-04-17 20:00:00,2227,null,98959,98959,98959,26,134,0,3913,760,4673
20200404,MI,16395,37405,null,2020-04-04 20:00:00,540,null,53800,53800,53800,26,61,0,3735,1143,4878
20200410,MI,22783,49261,null,2020-04-10 20:00:00,1281,null,72044,72044,72044,26,205,0,3711,1279,4990
20200330,MI,10901,21183,null,2020-03-30 20:00:00,184,null,32084,32084,32084,26,52,0,5507,891,6398
20200427,MI,38210,119550,null,2020-04-27 20:00:00,3407,null,157760,157760,157760,26,92,0,6322,432,6754
20200426,MI,37778,113228,null,2020-04-26 20:00:00,3315,null,151006,151006,151006,26,41,0,6387,575,6962
20200428,MI,39262,125543,null,2020-04-28 20:00:00,3567,null,164805,164805,164805,26,160,0,5993,1052,7045
20200429,MI,40399,131953,null,2020-04-29 20:00:00,3670,null,172352,172352,172352,26,103,0,6410,1137,7547
20200425,MI,37203,106841,null,2020-04-25 20:00:00,3274,null,144044,144044,144044,26,189,0,7186,562,7748
20200430,MI,41379,138888,null,2020-04-30 20:00:00,3789,null,180267,180267,180267,26,119,0,6935,980,7915
20200424,MI,36641,99655,null,2020-04-24 20:00:00,3085,null,136296,136296,136296,26,108,0,6625,1350,7975
20200504,MI,43950,178439,null,2020-05-04 20:00:00,4049,null,222389,222389,222389,26,0,0,9661,196,9857
20200419,MI,31424,78237,null,2020-04-19 20:00:00,2391,null,109661,109661,109661,26,83,0,9301,633,9934
20200423,MI,35291,93030,null,2020-04-23 20:00:00,2977,null,128321,128321,128321,26,164,0,8771,1325,10096
20200501,MI,42356,148149,null,2020-05-01 20:00:00,3866,null,190505,190505,190505,26,77,0,9261,977,10238
20200506,MI,45054,188177,null,2020-05-06 20:00:00,4250,null,233231,233231,233231,26,71,0,9738,657,10395
20200503,MI,43754,168778,null,2020-05-03 20:00:00,4049,null,212532,212532,212532,26,29,0,10276,547,10823
20200502,MI,43207,158502,null,2020-05-02 20:00:00,4020,null,201709,201709,201709,26,154,0,10353,851,11204
20200510,MI,47138,238540,null,2020-05-10 20:00:00,4551,null,285678,285678,285678,26,25,0,11810,382,12192
20200508,MI,46326,213927,null,2020-05-08 20:00:00,4393,null,260253,260253,260253,26,50,0,12511,680,13191
20200509,MI,46756,226730,null,2020-05-09 20:00:00,4526,null,273486,273486,273486,26,133,0,12803,430,13233
20200511,MI,47552,251396,null,2020-05-11 20:00:00,4584,null,298948,298948,298948,26,33,0,12856,414,13270
20200507,MI,45646,201416,null,2020-05-07 20:00:00,4343,null,247062,247062,247062,26,93,0,13239,592,13831
20200301,MI,9,null,null,2020-03-01 21:00:00,null,null,9,9,9,26,null,null,null,null,null
20200308,MN,1,48,null,2020-03-08 20:00:00,null,null,49,49,49,27,0,0,0,0,0
20200307,MN,1,48,null,2020-03-07 21:00:00,null,null,49,49,49,27,0,0,12,1,13
20200309,MN,2,80,null,2020-03-09 20:00:00,null,null,82,82,82,27,0,0,32,1,33
20200310,MN,3,132,null,2020-03-10 20:00:00,null,null,135,135,135,27,0,0,52,1,53
20200323,MN,235,4511,null,2020-03-23 20:00:00,1,17,4746,4746,4746,27,0,5,0,66,66
20200311,MN,5,217,null,2020-03-11 20:00:00,null,null,222,222,222,27,0,0,85,2,87
20200312,MN,9,307,null,2020-03-12 20:00:00,null,null,316,316,316,27,0,0,90,4,94
20200321,MN,138,3952,null,2020-03-21 20:00:00,1,null,4090,4090,4090,27,1,0,211,23,234
20200313,MN,14,541,null,2020-03-13 20:00:00,null,null,555,555,555,27,0,0,234,5,239
20200319,MN,89,2949,null,2020-03-19 20:00:00,null,null,3038,3038,3038,27,0,0,264,12,276
20200314,MN,21,847,null,2020-03-14 20:00:00,null,null,868,868,868,27,0,0,306,7,313
20200318,MN,77,2685,null,2020-03-18 20:00:00,null,null,2762,2762,2762,27,0,0,409,17,426
20200317,MN,60,2276,null,2020-03-17 20:00:00,null,null,2336,2336,2336,27,0,0,437,6,443
20200316,MN,54,1839,null,2020-03-16 20:00:00,null,null,1893,1893,1893,27,0,0,452,19,471
20200315,MN,35,1387,null,2020-03-15 20:00:00,null,null,1422,1422,1422,27,0,0,540,14,554
20200322,MN,169,4511,null,2020-03-22 20:00:00,1,12,4680,4680,4680,27,0,12,559,31,590
20200414,MN,1695,37546,null,2020-04-14 20:00:00,79,405,39241,39241,39241,27,9,44,769,45,814
20200320,MN,115,3741,null,2020-03-20 20:00:00,null,null,3856,3856,3856,27,0,0,792,26,818
20200421,MN,2567,45130,null,2020-04-21 20:00:00,160,629,47697,47697,47697,27,17,27,750,97,847
20200331,MN,629,19151,null,2020-03-31 20:00:00,12,112,19780,19780,19780,27,2,20,905,53,958
20200415,MN,1809,38433,null,2020-04-15 20:00:00,87,445,40242,40242,40242,27,8,40,887,114,1001
20200413,MN,1650,36777,null,2020-04-13 20:00:00,70,361,38427,38427,38427,27,0,0,977,29,1006
20200327,MN,398,13605,null,2020-03-27 20:00:00,4,51,14003,14003,14003,27,2,10,1001,52,1053
20200324,MN,262,5550,null,2020-03-24 20:00:00,1,21,5812,5812,5812,27,0,4,1039,27,1066
20200407,MN,1069,28191,null,2020-04-07 20:00:00,34,242,29260,29260,29260,27,4,19,1049,83,1132
20200420,MN,2470,44380,null,2020-04-20 20:00:00,143,602,46850,46850,46850,27,9,28,1020,114,1134
20200330,MN,576,18246,null,2020-03-30 20:00:00,10,92,18822,18822,18822,27,1,17,1092,73,1165
20200404,MN,865,24558,null,2020-04-04 20:00:00,24,180,25423,25423,25423,27,2,24,1120,76,1196
20200402,MN,742,21652,null,2020-04-02 20:00:00,18,138,22394,22394,22394,27,1,16,1150,53,1203
20200418,MN,2213,42055,null,2020-04-18 20:00:00,121,561,44268,44268,44268,27,10,43,1073,142,1215
20200406,MN,986,27142,null,2020-04-06 20:00:00,30,223,28128,28128,28128,27,1,21,1300,51,1351
20200405,MN,935,25842,null,2020-04-05 20:00:00,29,202,26777,26777,26777,27,5,22,1284,70,1354
20200417,MN,2071,40982,null,2020-04-17 20:00:00,111,518,43053,43053,43053,27,17,43,1219,159,1378
20200401,MN,689,20502,null,2020-04-01 20:00:00,17,122,21191,21191,21191,27,5,10,1351,60,1411
20200416,MN,1912,39763,null,2020-04-16 20:00:00,94,475,41675,41675,41675,27,7,30,1330,103,1433
20200419,MN,2356,43360,null,2020-04-19 20:00:00,134,574,45716,45716,45716,27,13,13,1305,143,1448
20200326,MN,346,12604,null,2020-03-26 20:00:00,2,41,12950,12950,12950,27,1,6,1416,59,1475
20200408,MN,1154,29599,null,2020-04-08 20:00:00,39,271,30753,30753,30753,27,5,29,1408,85,1493
20200411,MN,1427,33977,null,2020-04-11 20:00:00,64,340,35404,35404,35404,27,7,23,1419,91,1510
20200329,MN,503,17154,null,2020-03-29 20:00:00,9,75,17657,17657,17657,27,4,18,1466,62,1528
20200409,MN,1242,31052,null,2020-04-09 20:00:00,50,293,32294,32294,32294,27,11,22,1453,88,1541
20200410,MN,1336,32558,null,2020-04-10 20:00:00,57,317,33894,33894,33894,27,7,24,1506,94,1600
20200422,MN,2721,46623,null,2020-04-22 20:00:00,179,660,49344,49344,49344,27,19,31,1493,154,1647
20200403,MN,789,23438,null,2020-04-03 20:00:00,22,156,24227,24227,24227,27,4,18,1786,47,1833
20200412,MN,1621,35800,null,2020-04-12 20:00:00,70,361,37421,37421,37421,27,6,21,1823,194,2017
20200505,MN,7851,80158,null,2020-05-05 20:00:00,455,1350,88009,88009,88009,27,27,79,1451,617,2068
20200328,MN,441,15688,null,2020-03-28 20:00:00,5,57,16129,16129,16129,27,1,6,2083,43,2126
20200423,MN,2942,48606,null,2020-04-23 20:00:00,200,712,51548,51548,51548,27,21,52,1983,221,2204
20200424,MN,3185,50602,null,2020-04-24 20:00:00,221,756,53787,53787,53787,27,21,44,1996,243,2239
20200427,MN,3816,57452,null,2020-04-27 20:00:00,286,861,61268,61268,61268,27,14,32,2067,214,2281
20200426,MN,3602,55385,null,2020-04-26 20:00:00,272,829,58987,58987,58987,27,28,32,2234,156,2390
20200428,MN,4181,59648,null,2020-04-28 20:00:00,301,912,63829,63829,63829,27,15,51,2196,365,2561
20200425,MN,3446,53151,null,2020-04-25 20:00:00,244,797,56597,56597,56597,27,23,41,2549,261,2810
20200429,MN,4644,62100,null,2020-04-29 20:00:00,319,950,66744,66744,66744,27,18,38,2452,463,2915
20200504,MN,7234,78707,null,2020-05-04 20:00:00,428,1271,85941,85941,85941,27,9,72,2738,571,3309
20200430,MN,5136,65140,null,2020-04-30 20:00:00,343,1044,70276,70276,70276,27,24,94,3040,492,3532
20200503,MN,6663,75969,null,2020-05-03 20:00:00,419,1199,82632,82632,82632,27,24,40,3190,435,3625
20200508,MN,10088,91182,null,2020-05-08 20:00:00,534,1549,101270,101270,101270,27,26,90,3126,723,3849
20200502,MN,6228,72779,null,2020-05-02 20:00:00,395,1159,79007,79007,79007,27,24,63,3680,498,4178
20200507,MN,9365,88056,null,2020-05-07 20:00:00,508,1459,97421,97421,97421,27,23,54,3403,786,4189
20200501,MN,5730,69099,null,2020-05-01 20:00:00,371,1096,74829,74829,74829,27,28,52,3959,594,4553
20200511,MN,11799,103982,null,2020-05-11 20:00:00,591,1716,115781,115781,115781,27,13,59,4165,528,4693
20200510,MN,11271,99817,null,2020-05-10 20:00:00,578,1657,111088,111088,111088,27,20,45,4344,481,4825
20200509,MN,10790,95473,null,2020-05-09 20:00:00,558,1612,106263,106263,106263,27,24,63,4291,702,4993
20200506,MN,8579,84653,null,2020-05-06 20:00:00,485,1405,93232,93232,93232,27,30,55,4495,728,5223
20200325,MN,287,11188,null,2020-03-25 20:00:00,1,35,11475,11475,11475,27,0,14,5638,25,5663
20200306,MN,0,36,null,2020-03-06 21:00:00,null,null,36,36,36,27,null,null,null,null,null
20200324,MO,183,369,null,2020-03-24 20:00:00,3,null,552,552,552,29,0,0,0,0,0
20200311,MO,1,null,null,2020-03-11 20:00:00,null,null,1,1,1,29,0,0,0,0,0
20200310,MO,1,null,null,2020-03-10 20:00:00,null,null,1,1,1,29,0,0,0,0,0
20200309,MO,1,null,null,2020-03-09 20:00:00,null,null,1,1,1,29,0,0,0,0,0
20200308,MO,1,null,null,2020-03-08 20:00:00,null,null,1,1,1,29,0,0,0,1,1
20200313,MO,2,71,null,2020-03-13 20:00:00,null,null,73,73,73,29,0,0,7,1,8
20200322,MO,90,369,null,2020-03-22 20:00:00,3,null,459,459,459,29,0,0,0,17,17
20200314,MO,4,90,null,2020-03-14 20:00:00,0,null,94,94,94,29,0,0,19,2,21
20200321,MO,73,369,null,2020-03-21 20:00:00,3,null,442,442,442,29,2,0,0,26,26
20200315,MO,5,122,null,2020-03-15 20:00:00,0,null,127,127,127,29,0,0,32,1,33
20200316,MO,6,164,null,2020-03-16 20:00:00,0,null,170,170,170,29,0,0,42,1,43
20200317,MO,8,207,null,2020-03-17 20:00:00,0,null,215,215,215,29,0,0,43,2,45
20200318,MO,13,253,null,2020-03-18 20:00:00,0,null,266,266,266,29,0,0,46,5,51
20200312,MO,1,64,null,2020-03-12 20:00:00,null,null,65,65,65,29,0,0,64,0,64
20200319,MO,24,308,null,2020-03-19 20:00:00,1,null,332,332,332,29,1,0,55,11,66
20200511,MO,9918,105702,null,2020-05-11 20:00:00,488,null,115620,115620,115620,29,6,0,0,74,74
20200320,MO,47,369,null,2020-03-20 20:00:00,1,null,416,416,416,29,0,0,61,23,84
20200323,MO,183,369,null,2020-03-23 20:00:00,3,null,552,552,552,29,0,0,0,93,93
20200326,MO,502,369,null,2020-03-26 20:00:00,8,null,871,871,871,29,0,0,0,146,146
20200419,MO,5667,48242,null,2020-04-19 20:00:00,176,null,53909,53909,53909,29,1,0,0,150,150
20200327,MO,669,369,null,2020-03-27 20:00:00,8,null,1038,1038,1038,29,0,0,0,167,167
20200325,MO,356,369,null,2020-03-25 20:00:00,8,null,725,725,725,29,5,0,0,173,173
20200509,MO,9666,99232,null,2020-05-09 20:00:00,472,null,108898,108898,108898,29,23,0,0,177,177
20200413,MO,4388,41040,null,2020-04-13 20:00:00,114,null,45428,45428,45428,29,4,0,0,228,228
20200503,MO,8386,74590,null,2020-05-03 20:00:00,352,null,82976,82976,82976,29,1,0,0,232,232
20200502,MO,8154,74590,null,2020-05-02 20:00:00,351,null,82744,82744,82744,29,14,0,0,319,319
20200415,MO,4895,44117,null,2020-04-15 20:00:00,147,null,49012,49012,49012,29,14,0,825,209,1034
20200422,MO,6137,52019,null,2020-04-22 20:00:00,208,null,58156,58156,58156,29,19,0,840,196,1036
20200417,MO,5283,46434,null,2020-04-17 20:00:00,165,null,51717,51717,51717,29,13,0,897,172,1069
20200421,MO,5941,51179,null,2020-04-21 20:00:00,189,null,57120,57120,57120,29,12,0,973,134,1107
20200423,MO,6321,53129,null,2020-04-23 20:00:00,218,null,59450,59450,59450,29,10,0,1110,184,1294
20200427,MO,7171,63935,null,2020-04-27 20:00:00,288,null,71106,71106,71106,29,14,0,1184,174,1358
20200329,MO,838,11547,null,2020-03-29 20:00:00,10,null,12385,12385,12385,29,0,0,1465,0,1465
20200401,MO,1581,15846,null,2020-04-01 20:00:00,18,null,17427,17427,17427,29,4,0,1232,254,1486
20200416,MO,5111,45537,null,2020-04-16 20:00:00,152,null,50648,50648,50648,29,5,0,1420,216,1636
20200331,MO,1327,14614,null,2020-03-31 20:00:00,14,null,15941,15941,15941,29,1,0,1410,296,1706
20200501,MO,7835,74590,null,2020-05-01 20:00:00,337,null,82425,82425,82425,29,8,0,1465,273,1738
20200403,MO,2113,19357,null,2020-04-03 20:00:00,19,null,21470,21470,21470,29,0,0,1508,279,1787
20200330,MO,1031,13204,null,2020-03-30 20:00:00,13,null,14235,14235,14235,29,3,0,1657,193,1850
20200425,MO,6826,60392,null,2020-04-25 20:00:00,273,null,67218,67218,67218,29,11,0,1810,201,2011
20200412,MO,4160,41040,null,2020-04-12 20:00:00,110,null,45200,45200,45200,29,1,0,1892,136,2028
20200418,MO,5517,48242,null,2020-04-18 20:00:00,175,null,53759,53759,53759,29,10,0,1808,234,2042
20200420,MO,5807,50206,null,2020-04-20 20:00:00,177,null,56013,56013,56013,29,1,0,1964,140,2104
20200407,MO,3037,28932,null,2020-04-07 20:00:00,53,null,31969,31969,31969,29,14,0,1819,315,2134
20200408,MO,3327,30783,null,2020-04-08 20:00:00,58,null,34110,34110,34110,29,5,0,1851,290,2141
20200410,MO,3799,36941,null,2020-04-10 20:00:00,96,null,40740,40740,40740,29,19,0,1986,260,2246
20200402,MO,1834,17849,null,2020-04-02 20:00:00,19,null,19683,19683,19683,29,1,0,2003,253,2256
20200405,MO,2367,24882,null,2020-04-05 20:00:00,34,null,27249,27249,27249,29,10,0,2268,76,2344
20200428,MO,7303,66200,null,2020-04-28 20:00:00,314,null,73503,73503,73503,29,26,0,2265,132,2397
20200411,MO,4024,39148,null,2020-04-11 20:00:00,109,null,43172,43172,43172,29,13,0,2207,225,2432
20200426,MO,6997,62751,null,2020-04-26 20:00:00,274,null,69748,69748,69748,29,1,0,2359,171,2530
20200414,MO,4686,43292,null,2020-04-14 20:00:00,133,null,47978,47978,47978,29,19,0,2252,298,2550
20200406,MO,2722,27113,null,2020-04-06 20:00:00,39,null,29835,29835,29835,29,5,0,2231,355,2586
20200507,MO,9341,94281,null,2020-05-07 20:00:00,418,null,103622,103622,103622,29,22,0,2636,239,2875
20200404,MO,2291,22614,null,2020-04-04 20:00:00,24,null,24905,24905,24905,29,5,0,3257,178,3435
20200430,MO,7562,73125,null,2020-04-30 20:00:00,329,null,80687,80687,80687,29,11,0,3391,137,3528
20200505,MO,8916,86150,null,2020-05-05 20:00:00,377,null,95066,95066,95066,29,19,0,3453,162,3615
20200429,MO,7425,69734,null,2020-04-29 20:00:00,318,null,77159,77159,77159,29,4,0,3534,122,3656
20200409,MO,3539,34955,null,2020-04-09 20:00:00,77,null,38494,38494,38494,29,19,0,4172,212,4384
20200508,MO,9489,99232,null,2020-05-08 20:00:00,449,null,108721,108721,108721,29,31,0,4951,148,5099
20200506,MO,9102,91645,null,2020-05-06 20:00:00,396,null,100747,100747,100747,29,19,0,5495,186,5681
20200424,MO,6625,58582,null,2020-04-24 20:00:00,262,null,65207,65207,65207,29,44,0,5453,304,5757
20200510,MO,9844,105702,null,2020-05-10 20:00:00,482,null,115546,115546,115546,29,10,0,6470,178,6648
20200504,MO,8754,82697,null,2020-05-04 20:00:00,358,null,91451,91451,91451,29,6,0,8107,368,8475
20200328,MO,838,10082,null,2020-03-28 20:00:00,10,null,10920,10920,10920,29,2,0,9713,169,9882
20200307,MO,0,null,null,2020-03-07 21:00:00,null,null,0,0,0,29,null,null,null,null,null
20200510,MP,16,2321,null,2020-05-10 20:00:00,2,null,2337,2337,2337,69,0,0,0,0,0
20200507,MP,15,1783,null,2020-05-07 20:00:00,2,null,1798,1798,1798,69,0,0,0,0,0
20200504,MP,14,1321,null,2020-05-04 20:00:00,2,null,1335,1335,1335,69,0,0,0,0,0
20200428,MP,14,51,null,2020-04-28 20:00:00,2,null,65,65,65,69,0,0,0,0,0
20200427,MP,14,51,null,2020-04-27 20:00:00,2,null,65,65,65,69,0,0,0,0,0
20200426,MP,14,51,null,2020-04-26 20:00:00,2,null,65,65,65,69,0,0,0,0,0
20200425,MP,14,51,null,2020-04-25 20:00:00,2,null,65,65,65,69,0,0,0,0,0
20200424,MP,14,51,null,2020-04-24 20:00:00,2,null,65,65,65,69,0,0,0,0,0
20200423,MP,14,51,null,2020-04-23 20:00:00,2,null,65,65,65,69,0,0,0,0,0
20200422,MP,14,51,null,2020-04-22 20:00:00,2,null,65,65,65,69,0,0,0,0,0
20200421,MP,14,51,null,2020-04-21 20:00:00,2,null,65,65,65,69,0,0,0,0,0
20200419,MP,14,42,4,2020-04-19 20:00:00,2,null,60,56,56,69,0,0,0,0,0
20200416,MP,13,27,7,2020-04-16 20:00:00,2,null,47,40,40,69,0,0,0,0,0
20200415,MP,13,27,7,2020-04-15 20:00:00,2,null,47,40,40,69,0,0,0,0,0
20200413,MP,11,27,9,2020-04-13 20:00:00,2,null,47,38,38,69,0,0,0,0,0
20200412,MP,11,27,9,2020-04-12 20:00:00,2,null,47,38,38,69,0,0,0,0,0
20200411,MP,11,27,9,2020-04-11 20:00:00,2,null,47,38,38,69,0,0,0,0,0
20200410,MP,11,27,9,2020-04-10 20:00:00,2,null,47,38,38,69,0,0,0,0,0
20200409,MP,11,27,9,2020-04-09 20:00:00,2,null,47,38,38,69,0,0,0,0,0
20200406,MP,8,13,10,2020-04-06 20:00:00,1,null,31,21,21,69,0,0,0,0,0
20200405,MP,8,13,10,2020-04-05 20:00:00,1,null,31,21,21,69,0,0,0,0,0
20200404,MP,8,13,10,2020-04-04 20:00:00,1,null,31,21,21,69,0,0,0,0,0
20200403,MP,8,13,10,2020-04-03 20:00:00,1,null,31,21,21,69,0,0,0,0,0
20200331,MP,2,null,null,2020-03-31 20:00:00,null,null,2,2,2,69,0,0,0,0,0
20200330,MP,2,null,null,2020-03-30 20:00:00,null,null,2,2,2,69,0,0,0,0,0
20200329,MP,2,null,null,2020-03-29 20:00:00,null,null,2,2,2,69,0,0,0,0,0
20200327,MP,0,null,null,2020-03-27 20:00:00,0,null,0,0,0,69,0,0,0,0,0
20200326,MP,0,null,null,2020-03-26 20:00:00,0,null,0,0,0,69,0,0,0,0,0
20200325,MP,0,null,null,2020-03-25 20:00:00,0,null,0,0,0,69,0,0,0,0,0
20200324,MP,0,null,null,2020-03-24 20:00:00,0,null,0,0,0,69,0,0,0,0,0
20200323,MP,0,null,null,2020-03-23 20:00:00,0,null,0,0,0,69,0,0,0,0,0
20200322,MP,0,null,null,2020-03-22 20:00:00,0,null,0,0,0,69,0,0,0,0,0
20200321,MP,0,null,null,2020-03-21 20:00:00,0,null,0,0,0,69,0,0,0,0,0
20200320,MP,0,null,null,2020-03-20 20:00:00,0,null,0,0,0,69,0,0,0,0,0
20200319,MP,0,null,null,2020-03-19 20:00:00,0,null,0,0,0,69,0,0,0,0,0
20200318,MP,0,null,null,2020-03-18 20:00:00,0,null,0,0,0,69,0,0,0,0,0
20200317,MP,0,null,null,2020-03-17 20:00:00,null,null,0,0,0,69,0,0,0,0,0
20200509,MP,16,2321,null,2020-05-09 20:00:00,2,null,2337,2337,2337,69,0,0,0,1,1
20200506,MP,15,1783,null,2020-05-06 20:00:00,2,null,1798,1798,1798,69,0,0,0,1,1
20200418,MP,14,42,4,2020-04-18 20:00:00,2,null,60,56,56,69,0,0,0,1,1
20200414,MP,13,27,7,2020-04-14 20:00:00,2,null,47,40,40,69,0,0,0,2,2
20200407,MP,8,15,null,2020-04-07 20:00:00,2,null,23,23,23,69,1,0,2,0,2
20200328,MP,2,null,null,2020-03-28 20:00:00,null,null,2,2,2,69,0,0,0,2,2
20200401,MP,6,null,null,2020-04-01 20:00:00,null,null,6,6,6,69,0,0,0,4,4
20200420,MP,14,51,null,2020-04-20 20:00:00,2,null,65,65,65,69,0,0,9,0,9
20200417,MP,13,42,4,2020-04-17 20:00:00,2,null,59,55,55,69,0,0,15,0,15
20200408,MP,11,27,9,2020-04-08 20:00:00,2,null,47,38,38,69,0,0,12,3,15
20200402,MP,8,13,12,2020-04-02 20:00:00,1,null,33,21,21,69,1,0,13,2,15
20200429,MP,14,210,null,2020-04-29 20:00:00,2,null,224,224,224,69,0,0,159,0,159
20200501,MP,14,749,null,2020-05-01 20:00:00,2,null,763,763,763,69,0,0,164,0,164
20200502,MP,14,934,null,2020-05-02 20:00:00,2,null,948,948,948,69,0,0,185,0,185
20200511,MP,19,2676,null,2020-05-11 20:00:00,2,null,2695,2695,2695,69,0,0,355,3,358
20200430,MP,14,585,null,2020-04-30 20:00:00,2,null,599,599,599,69,0,0,375,0,375
20200503,MP,14,1321,null,2020-05-03 20:00:00,2,null,1335,1335,1335,69,0,0,387,0,387
20200505,MP,14,1783,null,2020-05-05 20:00:00,2,null,1797,1797,1797,69,0,0,462,0,462
20200508,MP,15,2321,null,2020-05-08 20:00:00,2,null,2336,2336,2336,69,0,0,538,0,538
20200316,MP,0,null,null,2020-03-16 20:00:00,null,null,0,0,0,69,null,null,null,null,null
20200310,MS,0,null,null,2020-03-10 20:00:00,null,null,0,0,0,28,0,0,0,0,0
20200309,MS,0,null,null,2020-03-09 20:00:00,null,null,0,0,0,28,0,0,0,0,0
20200308,MS,0,null,null,2020-03-08 20:00:00,null,null,0,0,0,28,0,0,0,0,0
20200313,MS,4,41,null,2020-03-13 20:00:00,null,null,45,45,45,28,0,0,0,3,3
20200315,MS,10,84,null,2020-03-15 20:00:00,null,null,94,94,94,28,0,0,0,4,4
20200311,MS,0,20,null,2020-03-11 20:00:00,null,null,20,20,20,28,0,0,20,0,20
20200312,MS,1,41,null,2020-03-12 20:00:00,null,null,42,42,42,28,0,0,21,1,22
20200314,MS,6,84,null,2020-03-14 20:00:00,null,null,90,90,90,28,0,0,43,2,45
20200321,MS,140,695,null,2020-03-21 20:00:00,1,null,835,835,835,28,0,0,0,60,60
20200325,MS,377,1566,null,2020-03-25 20:00:00,2,117,1943,1943,1943,28,1,31,14,57,71
20200323,MS,249,1143,null,2020-03-23 20:00:00,1,33,1392,1392,1392,28,0,0,29,42,71
20200328,MS,663,2560,null,2020-03-28 20:00:00,13,219,3223,3223,3223,28,5,34,0,84,84
20200408,MS,2003,18632,null,2020-04-08 20:00:00,67,410,20635,20635,20635,28,8,33,0,88,88
20200319,MS,50,552,null,2020-03-19 20:00:00,null,null,602,602,602,28,0,0,73,16,89
20200329,MS,758,2560,null,2020-03-29 20:00:00,14,235,3318,3318,3318,28,1,16,0,95,95
20200317,MS,21,368,null,2020-03-17 20:00:00,null,null,389,389,389,28,0,0,91,9,100
20200510,MS,9501,72101,null,2020-05-10 20:00:00,430,1531,81602,81602,81602,28,9,19,0,123,123
20200318,MS,34,479,null,2020-03-18 20:00:00,null,null,513,513,513,28,0,0,111,13,124
20200412,MS,2781,18632,null,2020-04-12 20:00:00,96,548,21413,21413,21413,28,3,20,0,139,139
20200417,MS,3793,34791,null,2020-04-17 20:00:00,140,736,38584,38584,38584,28,11,54,0,169,169
20200411,MS,2642,18632,null,2020-04-11 20:00:00,93,528,21274,21274,21274,28,11,46,0,173,173
20200320,MS,80,695,null,2020-03-20 20:00:00,1,null,775,775,775,28,1,0,143,30,173
20200407,MS,1915,18632,null,2020-04-07 20:00:00,59,377,20547,20547,20547,28,8,-98,0,177,177
20200418,MS,3974,34791,null,2020-04-18 20:00:00,152,782,38765,38765,38765,28,12,46,0,181,181
20200403,MS,1358,4753,null,2020-04-03 20:00:00,29,420,6111,6111,6111,28,3,60,0,181,181
20200316,MS,12,277,null,2020-03-16 20:00:00,null,null,289,289,289,28,0,0,193,2,195
20200410,MS,2469,18632,null,2020-04-10 20:00:00,82,482,21101,21101,21101,28,6,41,0,209,209
20200506,MS,8424,72101,null,2020-05-06 20:00:00,374,1392,80525,80525,80525,28,32,40,0,217,217
20200430,MS,6815,59525,null,2020-04-30 20:00:00,261,1175,66340,66340,66340,28,11,49,0,246,246
20200409,MS,2260,18632,null,2020-04-09 20:00:00,76,441,20892,20892,20892,28,9,31,0,257,257
20200507,MS,8686,72101,null,2020-05-07 20:00:00,396,1442,80787,80787,80787,28,22,50,0,262,262
20200416,MS,3624,34791,null,2020-04-16 20:00:00,129,682,38415,38415,38415,28,7,37,0,264,264
20200415,MS,3360,34791,null,2020-04-15 20:00:00,122,645,38151,38151,38151,28,11,49,0,273,273
20200424,MS,5434,50236,null,2020-04-24 20:00:00,209,970,55670,55670,55670,28,8,24,0,281,281
20200509,MS,9378,72101,null,2020-05-09 20:00:00,421,1512,81479,81479,81479,28,12,34,0,288,288
20200419,MS,4274,34791,null,2020-04-19 20:00:00,159,808,39065,39065,39065,28,7,26,0,300,300
20200401,MS,1073,3712,null,2020-04-01 20:00:00,22,332,4785,4785,4785,28,2,121,175,136,311
20200327,MS,579,2560,null,2020-03-27 20:00:00,8,185,3139,3139,3139,28,2,35,269,94,363
20200508,MS,9090,72101,null,2020-05-08 20:00:00,409,1478,81191,81191,81191,28,13,36,0,404,404
20200404,MS,1455,5133,null,2020-04-04 20:00:00,35,436,6588,6588,6588,28,6,16,380,97,477
20200324,MS,320,1552,null,2020-03-24 20:00:00,1,86,1872,1872,1872,28,0,53,409,71,480
20200322,MS,207,1114,null,2020-03-22 20:00:00,1,33,1321,1321,1321,28,0,33,419,67,486
20200330,MS,847,2989,null,2020-03-30 20:00:00,16,195,3836,3836,3836,28,2,-40,429,89,518
20200405,MS,1638,5580,null,2020-04-05 20:00:00,43,475,7218,7218,7218,28,8,39,447,183,630
20200505,MS,8207,72101,null,2020-05-05 20:00:00,342,1352,80308,80308,80308,28,32,36,301,330,631
20200331,MS,937,3537,null,2020-03-31 20:00:00,20,211,4474,4474,4474,28,4,16,548,90,638
20200326,MS,485,2291,null,2020-03-26 20:00:00,6,150,2776,2776,2776,28,4,33,725,108,833
20200421,MS,4716,47648,null,2020-04-21 20:00:00,183,858,52364,52364,52364,28,14,39,726,204,930
20200428,MS,6342,58070,null,2020-04-28 20:00:00,239,1088,64412,64412,64412,28,10,28,702,248,950
20200402,MS,1177,4753,null,2020-04-02 20:00:00,26,360,5930,5930,5930,28,4,28,1041,104,1145
20200422,MS,4894,48941,null,2020-04-22 20:00:00,193,910,53835,53835,53835,28,10,52,1293,178,1471
20200423,MS,5153,50236,null,2020-04-23 20:00:00,201,946,55389,55389,55389,28,8,36,1295,259,1554
20200429,MS,6569,59525,null,2020-04-29 20:00:00,250,1126,66094,66094,66094,28,11,38,1455,227,1682
20200426,MS,5911,54877,null,2020-04-26 20:00:00,227,1001,60788,60788,60788,28,6,5,1638,193,1831
20200504,MS,7877,71800,null,2020-05-04 20:00:00,310,1316,79677,79677,79677,28,7,18,1757,327,2084
20200427,MS,6094,57368,null,2020-04-27 20:00:00,229,1060,63462,63462,63462,28,2,59,2491,183,2674
20200502,MS,7441,67034,null,2020-05-02 20:00:00,291,1265,74475,74475,74475,28,10,39,2698,229,2927
20200503,MS,7550,70043,null,2020-05-03 20:00:00,303,1298,77593,77593,77593,28,12,33,3009,109,3118
20200425,MS,5718,53239,null,2020-04-25 20:00:00,221,996,58957,58957,58957,28,12,26,3003,284,3287
20200501,MS,7212,64336,null,2020-05-01 20:00:00,281,1226,71548,71548,71548,28,20,51,4811,397,5208
20200414,MS,3087,34791,null,2020-04-14 20:00:00,111,596,37878,37878,37878,28,13,47,6749,145,6894
20200413,MS,2942,28042,null,2020-04-13 20:00:00,98,549,30984,30984,30984,28,2,1,9410,161,9571
20200420,MS,4512,46922,null,2020-04-20 20:00:00,169,819,51434,51434,51434,28,10,11,12131,238,12369
20200406,MS,1738,18632,null,2020-04-06 20:00:00,51,475,20370,20370,20370,28,8,0,13052,100,13152
20200511,MS,9674,86211,null,2020-05-11 20:00:00,435,1546,95885,95885,95885,28,5,15,14110,173,14283
20200307,MS,0,null,null,2020-03-07 21:00:00,null,null,0,0,0,28,null,null,null,null,null
20200309,MT,0,11,null,2020-03-09 20:00:00,null,null,11,11,11,30,0,0,0,0,0
20200308,MT,0,11,null,2020-03-08 20:00:00,null,null,11,11,11,30,0,0,0,0,0
20200315,MT,7,103,57,2020-03-15 20:00:00,null,null,167,110,110,30,0,0,0,2,2
20200323,MT,34,1146,null,2020-03-23 20:00:00,null,null,1180,1180,1180,30,0,0,0,3,3
20200310,MT,0,15,null,2020-03-10 20:00:00,null,null,15,15,15,30,0,0,4,0,4
20200311,MT,0,21,null,2020-03-11 20:00:00,null,null,21,21,21,30,0,0,6,0,6
20200322,MT,31,1146,null,2020-03-22 20:00:00,null,null,1177,1177,1177,30,0,0,0,11,11
20200312,MT,1,34,null,2020-03-12 20:00:00,null,null,35,35,35,30,0,0,13,1,14
20200330,MT,171,4143,null,2020-03-30 20:00:00,4,10,4314,4314,4314,30,3,2,0,17,17
20200313,MT,1,55,null,2020-03-13 20:00:00,null,null,56,56,56,30,0,0,21,0,21
20200314,MT,5,103,null,2020-03-14 20:00:00,null,null,108,108,108,30,0,0,48,4,52
20200504,MT,457,14631,null,2020-05-04 20:00:00,16,62,15088,15088,15088,30,0,1,79,2,81
20200316,MT,7,198,null,2020-03-16 20:00:00,null,null,205,205,205,30,0,0,95,0,95
20200331,MT,184,4234,null,2020-03-31 20:00:00,4,14,4418,4418,4418,30,0,4,91,13,104
20200317,MT,8,303,null,2020-03-17 20:00:00,null,null,311,311,311,30,0,0,105,1,106
20200414,MT,399,8835,null,2020-04-14 20:00:00,7,50,9234,9234,9234,30,0,3,131,5,136
20200420,MT,433,10618,null,2020-04-20 20:00:00,10,57,11051,11051,11051,30,0,2,153,0,153
20200428,MT,451,12740,null,2020-04-28 20:00:00,15,61,13191,13191,13191,30,1,0,156,2,158
20200427,MT,449,12584,null,2020-04-27 20:00:00,14,61,13033,13033,13033,30,0,0,170,1,171
20200320,MT,16,931,null,2020-03-20 20:00:00,null,null,947,947,947,30,0,0,170,4,174
20200505,MT,456,14816,null,2020-05-05 20:00:00,16,62,15272,15272,15272,30,0,0,185,-1,184
20200413,MT,394,8704,null,2020-04-13 20:00:00,7,47,9098,9098,9098,30,1,0,178,7,185
20200406,MT,299,6491,null,2020-04-06 20:00:00,6,24,6790,6790,6790,30,0,0,174,13,187
20200421,MT,437,10804,null,2020-04-21 20:00:00,12,59,11241,11241,11241,30,2,2,186,4,190
20200407,MT,319,6666,null,2020-04-07 20:00:00,6,28,6985,6985,6985,30,0,4,175,20,195
20200326,MT,71,2128,null,2020-03-26 20:00:00,null,1,2199,2199,2199,30,0,1,180,18,198
20200318,MT,10,499,null,2020-03-18 20:00:00,null,null,509,509,509,30,0,0,196,2,198
20200321,MT,20,1146,null,2020-03-21 20:00:00,null,null,1166,1166,1166,30,0,0,215,4,219
20200424,MT,444,11683,null,2020-04-24 20:00:00,14,59,12127,12127,12127,30,0,0,250,2,252
20200403,MT,243,5333,null,2020-04-03 20:00:00,5,24,5576,5576,5576,30,0,4,240,16,256
20200319,MT,12,761,null,2020-03-19 20:00:00,null,null,773,773,773,30,0,0,262,2,264
20200411,MT,377,8204,null,2020-04-11 20:00:00,6,46,8581,8581,8581,30,0,5,272,12,284
20200501,MT,453,13750,null,2020-05-01 20:00:00,16,61,14203,14203,14203,30,0,0,289,0,289
20200423,MT,442,11433,null,2020-04-23 20:00:00,14,59,11875,11875,11875,30,0,0,289,3,292
20200417,MT,422,9822,null,2020-04-17 20:00:00,8,54,10244,10244,10244,30,1,2,301,7,308
20200325,MT,53,1948,null,2020-03-25 20:00:00,null,null,2001,2001,2001,30,0,0,305,7,312
20200418,MT,426,10143,null,2020-04-18 20:00:00,10,55,10569,10569,10569,30,2,1,321,4,325
20200419,MT,433,10465,null,2020-04-19 20:00:00,10,55,10898,10898,10898,30,0,0,322,7,329
20200412,MT,387,8526,null,2020-04-12 20:00:00,6,47,8913,8913,8913,30,0,1,322,10,332
20200429,MT,451,13077,null,2020-04-29 20:00:00,16,61,13528,13528,13528,30,1,0,337,0,337
20200422,MT,439,11144,null,2020-04-22 20:00:00,14,59,11583,11583,11583,30,2,0,340,2,342
20200415,MT,404,9179,null,2020-04-15 20:00:00,7,51,9583,9583,9583,30,0,1,344,5,349
20200416,MT,415,9521,null,2020-04-16 20:00:00,7,52,9936,9936,9936,30,0,1,342,11,353
20200426,MT,448,12414,null,2020-04-26 20:00:00,14,61,12862,12862,12862,30,0,0,362,3,365
20200425,MT,445,12052,null,2020-04-25 20:00:00,14,61,12497,12497,12497,30,0,2,369,1,370
20200503,MT,455,14552,null,2020-05-03 20:00:00,16,61,15007,15007,15007,30,0,0,372,0,372
20200510,MT,458,21246,null,2020-05-10 20:00:00,16,62,21704,21704,21704,30,0,0,375,0,375
20200509,MT,458,20871,null,2020-05-09 20:00:00,16,62,21329,21329,21329,30,0,0,384,0,384
20200430,MT,453,13461,null,2020-04-30 20:00:00,16,61,13914,13914,13914,30,0,0,384,2,386
20200402,MT,227,5093,null,2020-04-02 20:00:00,5,20,5320,5320,5320,30,0,3,383,19,402
20200408,MT,332,7066,null,2020-04-08 20:00:00,6,31,7398,7398,7398,30,0,3,400,13,413
20200405,MT,286,6317,null,2020-04-05 20:00:00,6,24,6603,6603,6603,30,1,0,405,21,426
20200502,MT,455,14180,null,2020-05-02 20:00:00,16,61,14635,14635,14635,30,0,0,430,2,432
20200410,MT,365,7932,null,2020-04-10 20:00:00,6,41,8297,8297,8297,30,0,5,426,11,437
20200409,MT,354,7506,null,2020-04-09 20:00:00,6,36,7860,7860,7860,30,0,5,440,22,462
20200327,MT,108,2590,null,2020-03-27 20:00:00,null,7,2698,2698,2698,30,0,6,462,37,499
20200401,MT,208,4710,null,2020-04-01 20:00:00,5,17,4918,4918,4918,30,1,3,476,24,500
20200324,MT,46,1643,null,2020-03-24 20:00:00,null,null,1689,1689,1689,30,0,0,497,12,509
20200507,MT,456,19791,null,2020-05-07 20:00:00,16,62,20247,20247,20247,30,0,0,543,0,543
20200404,MT,265,5912,null,2020-04-04 20:00:00,5,24,6177,6177,6177,30,0,0,579,22,601
20200328,MT,129,3256,null,2020-03-28 20:00:00,1,7,3385,3385,3385,30,1,0,666,21,687
20200508,MT,458,20487,null,2020-05-08 20:00:00,16,62,20945,20945,20945,30,0,0,696,2,698
20200511,MT,459,22113,null,2020-05-11 20:00:00,16,62,22572,22572,22572,30,0,0,867,1,868
20200329,MT,154,4143,null,2020-03-29 20:00:00,1,8,4297,4297,4297,30,0,1,887,25,912
20200506,MT,456,19248,null,2020-05-06 20:00:00,16,62,19704,19704,19704,30,0,0,4432,0,4432
20200307,MT,0,11,null,2020-03-07 21:00:00,null,null,11,11,11,30,null,null,null,null,null
20200311,NC,7,null,null,2020-03-11 20:00:00,null,null,7,7,7,37,0,0,0,0,0
20200309,NC,2,null,null,2020-03-09 20:00:00,null,null,2,2,2,37,0,0,0,0,0
20200308,NC,2,null,null,2020-03-08 20:00:00,null,null,2,2,2,37,0,0,0,0,0
20200307,NC,2,null,null,2020-03-07 21:00:00,null,null,2,2,2,37,0,0,0,0,0
20200305,NC,1,null,null,2020-03-05 21:00:00,null,null,1,1,1,37,0,0,0,0,0
20200306,NC,2,null,null,2020-03-06 21:00:00,null,null,2,2,2,37,0,0,0,1,1
20200310,NC,7,null,null,2020-03-10 20:00:00,null,null,7,7,7,37,0,0,0,5,5
20200313,NC,15,86,null,2020-03-13 20:00:00,null,null,101,101,101,37,0,0,26,3,29
20200314,NC,23,137,null,2020-03-14 20:00:00,null,null,160,160,160,37,0,0,51,8,59
20200312,NC,12,60,null,2020-03-12 20:00:00,null,null,72,72,72,37,0,0,60,5,65
20200316,NC,33,296,151,2020-03-16 20:00:00,0,null,480,329,329,37,0,0,69,1,70
20200315,NC,32,227,151,2020-03-15 20:00:00,null,null,410,259,259,37,0,0,90,9,99
20200324,NC,398,8141,null,2020-03-24 20:00:00,0,null,8539,8539,8539,37,0,0,0,101,101
20200317,NC,40,474,null,2020-03-17 20:00:00,0,null,514,514,514,37,0,0,178,7,185
20200407,NC,3221,37861,null,2020-04-07 20:00:00,46,null,41082,41082,41082,37,13,0,5,351,356
20200319,NC,97,2408,null,2020-03-19 20:00:00,0,null,2505,2505,2505,37,0,0,621,34,655
20200406,NC,2870,37856,null,2020-04-06 20:00:00,33,null,40726,40726,40726,37,2,0,396,285,681
20200420,NC,6764,72720,null,2020-04-20 20:00:00,179,null,79484,79484,79484,37,7,0,441,271,712
20200320,NC,137,3096,null,2020-03-20 20:00:00,0,null,3233,3233,3233,37,0,0,688,40,728
20200322,NC,255,6183,null,2020-03-22 20:00:00,0,null,6438,6438,6438,37,0,0,1091,71,1162
20200413,NC,4816,58572,null,2020-04-13 20:00:00,86,null,63388,63388,63388,37,5,0,953,296,1249
20200405,NC,2585,37460,null,2020-04-05 20:00:00,31,null,40045,40045,40045,37,7,0,1089,183,1272
20200318,NC,63,1787,null,2020-03-18 20:00:00,0,null,1850,1850,1850,37,0,0,1313,23,1336
20200329,NC,1040,17905,null,2020-03-29 20:00:00,4,null,18945,18945,18945,37,0,0,1313,105,1418
20200414,NC,5024,60015,null,2020-04-14 20:00:00,108,null,65039,65039,65039,37,22,0,1443,208,1651
20200412,NC,4520,57619,null,2020-04-12 20:00:00,81,null,62139,62139,62139,37,1,0,1538,208,1746
20200408,NC,3426,39561,null,2020-04-08 20:00:00,53,null,42987,42987,42987,37,7,0,1700,205,1905
20200330,NC,1307,19557,null,2020-03-30 20:00:00,6,null,20864,20864,20864,37,2,0,1652,267,1919
20200325,NC,504,9985,null,2020-03-25 20:00:00,1,null,10489,10489,10489,37,1,0,1844,106,1950
20200323,NC,297,8141,null,2020-03-23 20:00:00,0,null,8438,8438,8438,37,0,0,1958,42,2000
20200427,NC,9142,100778,null,2020-04-27 20:00:00,306,null,109920,109920,109920,37,7,0,1714,312,2026
20200321,NC,184,5092,null,2020-03-21 20:00:00,0,null,5276,5276,5276,37,0,0,1996,47,2043
20200417,NC,5859,67122,null,2020-04-17 20:00:00,152,null,72981,72981,72981,37,21,0,1670,394,2064
20200327,NC,763,14373,null,2020-03-27 20:00:00,3,null,15136,15136,15136,37,1,0,2099,127,2226
20200331,NC,1498,21608,null,2020-03-31 20:00:00,8,null,23106,23106,23106,37,2,0,2051,191,2242
20200328,NC,935,16592,null,2020-03-28 20:00:00,4,null,17527,17527,17527,37,1,0,2219,172,2391
20200326,NC,636,12274,null,2020-03-26 20:00:00,2,null,12910,12910,12910,37,1,0,2289,132,2421
20200402,NC,1857,26822,null,2020-04-02 20:00:00,16,null,28679,28679,28679,37,6,0,2163,273,2436
20200419,NC,6493,72279,null,2020-04-19 20:00:00,172,null,78772,78772,78772,37,8,0,2208,353,2561
20200504,NC,11848,134591,null,2020-05-04 20:00:00,430,null,146439,146439,146439,37,8,0,2420,184,2604
20200426,NC,8830,99064,null,2020-04-26 20:00:00,299,null,107894,107894,107894,37,10,0,2422,207,2629
20200411,NC,4312,56081,null,2020-04-11 20:00:00,80,null,60393,60393,60393,37,6,0,2344,404,2748
20200415,NC,5123,62704,null,2020-04-15 20:00:00,117,null,67827,67827,67827,37,9,0,2689,99,2788
20200428,NC,9568,103184,null,2020-04-28 20:00:00,342,null,112752,112752,112752,37,36,0,2406,426,2832
20200403,NC,2093,29505,null,2020-04-03 20:00:00,19,null,31598,31598,31598,37,3,0,2683,236,2919
20200416,NC,5465,65452,null,2020-04-16 20:00:00,131,null,70917,70917,70917,37,14,0,2748,342,3090
20200401,NC,1584,24659,null,2020-04-01 20:00:00,10,null,26243,26243,26243,37,2,0,3051,86,3137
20200418,NC,6140,70071,null,2020-04-18 20:00:00,164,null,76211,76211,76211,37,12,0,2949,281,3230
20200511,NC,15045,180820,null,2020-05-11 20:00:00,550,null,195865,195865,195865,37,3,0,3449,281,3730
20200421,NC,6951,76380,null,2020-04-21 20:00:00,213,null,83331,83331,83331,37,34,0,3660,187,3847
20200503,NC,11664,132171,null,2020-05-03 20:00:00,422,null,143835,143835,143835,37,2,0,4205,155,4360
20200424,NC,8052,92532,null,2020-04-24 20:00:00,269,null,100584,100584,100584,37,16,0,3955,444,4399
20200425,NC,8623,96642,null,2020-04-25 20:00:00,289,null,105265,105265,105265,37,20,0,4110,571,4681
20200409,NC,3651,44158,null,2020-04-09 20:00:00,65,null,47809,47809,47809,37,12,0,4597,225,4822
20200505,NC,12256,139544,null,2020-05-05 20:00:00,452,null,151800,151800,151800,37,22,0,4953,408,5361
20200502,NC,11509,127966,null,2020-05-02 20:00:00,420,null,139475,139475,139475,37,21,0,5057,586,5643
20200429,NC,9948,108492,null,2020-04-29 20:00:00,354,null,118440,118440,118440,37,12,0,5308,380,5688
20200510,NC,14764,177371,null,2020-05-10 20:00:00,547,null,192135,192135,192135,37,3,0,5369,404,5773
20200501,NC,10923,122909,null,2020-05-01 20:00:00,399,null,133832,133832,133832,37,21,0,5382,414,5796
20200423,NC,7608,88577,null,2020-04-23 20:00:00,253,null,96185,96185,96185,37,11,0,5461,388,5849
20200507,NC,13397,157931,null,2020-05-07 20:00:00,507,null,171328,171328,171328,37,30,0,6207,639,6846
20200422,NC,7220,83116,null,2020-04-22 20:00:00,242,null,90336,90336,90336,37,29,0,6736,269,7005
20200404,NC,2402,36371,null,2020-04-04 20:00:00,24,null,38773,38773,38773,37,5,0,6866,309,7175
20200508,NC,13868,164745,null,2020-05-08 20:00:00,527,null,178613,178613,178613,37,20,0,6814,471,7285
20200509,NC,14360,172002,null,2020-05-09 20:00:00,544,null,186362,186362,186362,37,17,0,7257,492,7749
20200430,NC,10509,117527,null,2020-04-30 20:00:00,378,null,128036,128036,128036,37,24,0,9035,561,9596
20200410,NC,3908,53737,null,2020-04-10 20:00:00,74,null,57645,57645,57645,37,9,0,9579,257,9836
20200506,NC,12758,151724,null,2020-05-06 20:00:00,477,null,164482,164482,164482,37,25,0,12180,502,12682
20200304,NC,1,null,null,2020-03-04 21:00:00,null,null,1,1,1,37,null,null,null,null,null
20200309,ND,0,0,null,2020-03-09 20:00:00,null,null,0,0,0,38,0,0,0,0,0
20200308,ND,0,0,null,2020-03-08 20:00:00,null,null,0,0,0,38,0,0,0,0,0
20200311,ND,0,7,6,2020-03-11 20:00:00,null,null,13,7,7,38,0,0,1,0,1
20200312,ND,1,12,14,2020-03-12 20:00:00,null,null,27,13,13,38,0,0,5,1,6
20200310,ND,0,6,2,2020-03-10 20:00:00,null,null,8,6,6,38,0,0,6,0,6
20200314,ND,1,54,14,2020-03-14 20:00:00,0,null,69,55,55,38,0,0,15,0,15
20200313,ND,1,39,12,2020-03-13 20:00:00,0,null,52,40,40,38,0,0,27,0,27
20200316,ND,1,123,0,2020-03-16 20:00:00,0,null,124,124,124,38,0,0,28,0,28
20200315,ND,1,95,4,2020-03-15 20:00:00,0,null,100,96,96,38,0,0,41,0,41
20200318,ND,6,268,null,2020-03-18 20:00:00,0,null,274,274,274,38,0,0,48,3,51
20200323,ND,30,1353,null,2020-03-23 20:00:00,0,4,1383,1383,1383,38,0,1,93,2,95
20200317,ND,3,220,0,2020-03-17 20:00:00,0,null,223,223,223,38,0,0,97,2,99
20200324,ND,34,1454,null,2020-03-24 20:00:00,0,5,1488,1488,1488,38,0,1,101,4,105
20200322,ND,28,1260,null,2020-03-22 20:00:00,0,3,1288,1288,1288,38,0,0,119,0,119
20200414,ND,341,10575,null,2020-04-14 20:00:00,9,42,10916,10916,10916,38,1,2,125,10,135
20200319,ND,15,493,null,2020-03-19 20:00:00,0,null,508,508,508,38,0,0,225,9,234
20200401,ND,142,4351,null,2020-04-01 20:00:00,3,23,4493,4493,4493,38,0,2,220,16,236
20200421,ND,644,14343,null,2020-04-21 20:00:00,13,54,14987,14987,14987,38,0,1,223,17,240
20200412,ND,308,10042,null,2020-04-12 20:00:00,8,39,10350,10350,10350,38,1,3,255,15,270
20200325,ND,39,1734,null,2020-03-25 20:00:00,0,8,1773,1773,1773,38,0,3,280,5,285
20200320,ND,20,800,null,2020-03-20 20:00:00,0,null,820,820,820,38,0,0,307,5,312
20200326,ND,52,2039,null,2020-03-26 20:00:00,0,10,2091,2091,2091,38,0,2,305,13,318
20200321,ND,28,1141,null,2020-03-21 20:00:00,0,3,1169,1169,1169,38,0,3,341,8,349
20200330,ND,109,3728,null,2020-03-30 20:00:00,2,19,3837,3837,3837,38,1,2,373,11,384
20200416,ND,393,11311,null,2020-04-16 20:00:00,9,45,11704,11704,11704,38,0,1,359,28,387
20200328,ND,83,2809,null,2020-03-28 20:00:00,1,16,2892,2892,2892,38,1,3,382,18,400
20200415,ND,365,10952,null,2020-04-15 20:00:00,9,44,11317,11317,11317,38,0,2,377,24,401
20200327,ND,65,2427,null,2020-03-27 20:00:00,0,13,2492,2492,2492,38,0,3,388,13,401
20200404,ND,186,6021,null,2020-04-04 20:00:00,3,30,6207,6207,6207,38,0,1,396,13,409
20200331,ND,126,4131,null,2020-03-31 20:00:00,3,21,4257,4257,4257,38,1,2,403,17,420
20200406,ND,225,6988,null,2020-04-06 20:00:00,3,32,7213,7213,7213,38,0,1,408,18,426
20200413,ND,331,10450,null,2020-04-13 20:00:00,8,40,10781,10781,10781,38,0,1,408,23,431
20200409,ND,269,8721,null,2020-04-09 20:00:00,5,34,8990,8990,8990,38,1,0,420,18,438
20200411,ND,293,9787,null,2020-04-11 20:00:00,7,36,10080,10080,10080,38,1,0,457,15,472
20200402,ND,159,4821,null,2020-04-02 20:00:00,3,28,4980,4980,4980,38,0,5,470,17,487
20200407,ND,237,7466,null,2020-04-07 20:00:00,4,33,7703,7703,7703,38,1,1,478,12,490
20200329,ND,98,3355,null,2020-03-29 20:00:00,1,17,3453,3453,3453,38,0,1,546,15,561
20200405,ND,207,6580,null,2020-04-05 20:00:00,3,31,6787,6787,6787,38,0,1,559,21,580
20200422,ND,679,14910,null,2020-04-22 20:00:00,14,62,15589,15589,15589,38,1,8,567,35,602
20200410,ND,278,9330,null,2020-04-10 20:00:00,6,36,9608,9608,9608,38,1,2,609,9,618
20200418,ND,528,12435,null,2020-04-18 20:00:00,9,47,12963,12963,12963,38,0,0,532,89,621
20200417,ND,439,11903,null,2020-04-17 20:00:00,9,47,12342,12342,12342,38,0,2,592,46,638
20200419,ND,585,13045,null,2020-04-19 20:00:00,10,51,13630,13630,13630,38,1,4,610,57,667
20200423,ND,709,15621,null,2020-04-23 20:00:00,15,65,16330,16330,16330,38,1,3,711,30,741
20200403,ND,173,5625,null,2020-04-03 20:00:00,3,29,5798,5798,5798,38,0,1,804,14,818
20200408,ND,251,8301,null,2020-04-08 20:00:00,4,34,8552,8552,8552,38,0,1,835,14,849
20200510,ND,1491,43378,null,2020-05-10 20:00:00,35,110,44869,44869,44869,38,0,0,909,27,936
20200420,ND,627,14120,null,2020-04-20 20:00:00,13,53,14747,14747,14747,38,3,2,1075,42,1117
20200424,ND,748,16701,null,2020-04-24 20:00:00,15,67,17449,17449,17449,38,0,2,1080,39,1119
20200428,ND,991,22732,null,2020-04-28 20:00:00,19,79,23723,23723,23723,38,0,2,1240,49,1289
20200426,ND,867,19850,null,2020-04-26 20:00:00,17,71,20717,20717,20717,38,1,1,1303,64,1367
20200504,ND,1225,33529,null,2020-05-04 20:00:00,25,94,34754,34754,34754,38,0,4,1367,34,1401
20200509,ND,1464,42469,null,2020-05-09 20:00:00,35,110,43933,43933,43933,38,2,6,1393,39,1432
20200508,ND,1425,41076,null,2020-05-08 20:00:00,33,104,42501,42501,42501,38,2,2,1580,54,1634
20200505,ND,1266,35155,null,2020-05-05 20:00:00,25,95,36421,36421,36421,38,0,1,1626,41,1667
20200427,ND,942,21492,null,2020-04-27 20:00:00,19,77,22434,22434,22434,38,2,6,1642,75,1717
20200503,ND,1191,32162,null,2020-05-03 20:00:00,25,90,33353,33353,33353,38,1,0,1768,38,1806
20200429,ND,1033,24503,null,2020-04-29 20:00:00,19,82,25536,25536,25536,38,0,3,1771,42,1813
20200425,ND,803,18547,null,2020-04-25 20:00:00,16,70,19350,19350,19350,38,1,3,1846,55,1901
20200430,ND,1067,26393,null,2020-04-30 20:00:00,19,85,27460,27460,27460,38,0,3,1890,34,1924
20200502,ND,1153,30394,null,2020-05-02 20:00:00,24,90,31547,31547,31547,38,1,4,1976,46,2022
20200501,ND,1107,28418,null,2020-05-01 20:00:00,23,86,29525,29525,29525,38,4,1,2025,40,2065
20200511,ND,1518,45496,null,2020-05-11 20:00:00,36,115,47014,47014,47014,38,1,5,2118,27,2145
20200506,ND,1323,37309,null,2020-05-06 20:00:00,31,97,38632,38632,38632,38,6,2,2154,57,2211
20200507,ND,1371,39496,null,2020-05-07 20:00:00,31,102,40867,40867,40867,38,0,5,2187,48,2235
20200307,ND,0,0,null,2020-03-07 21:00:00,null,null,0,0,0,38,null,null,null,null,null
20200308,NE,1,17,5,2020-03-08 20:00:00,null,null,23,18,18,31,0,0,0,0,0
20200306,NE,0,17,5,2020-03-06 21:00:00,null,null,22,17,17,31,0,0,0,0,0
20200314,NE,14,80,33,2020-03-14 20:00:00,null,null,127,94,94,31,0,0,0,1,1
20200307,NE,1,17,5,2020-03-07 21:00:00,null,null,23,18,18,31,0,0,0,1,1
20200323,NE,50,356,null,2020-03-23 20:00:00,0,null,406,406,406,31,0,0,0,2,2
20200311,NE,5,47,16,2020-03-11 20:00:00,null,null,68,52,52,31,0,0,0,2,2
20200318,NE,24,206,null,2020-03-18 20:00:00,null,null,230,230,230,31,0,0,0,3,3
20200315,NE,17,80,33,2020-03-15 20:00:00,null,null,130,97,97,31,0,0,0,3,3
20200313,NE,13,80,33,2020-03-13 20:00:00,null,null,126,93,93,31,0,0,0,3,3
20200320,NE,32,240,null,2020-03-20 20:00:00,0,null,272,272,272,31,0,0,0,5,5
20200322,NE,48,356,null,2020-03-22 20:00:00,0,null,404,404,404,31,0,0,0,10,10
20200310,NE,3,47,16,2020-03-10 20:00:00,null,null,66,50,50,31,0,0,11,0,11
20200309,NE,3,36,9,2020-03-09 20:00:00,null,null,48,39,39,31,0,0,19,2,21
20200429,NE,3374,20257,null,2020-04-29 20:00:00,55,null,23631,23631,23631,31,0,0,10,16,26
20200319,NE,27,240,null,2020-03-19 20:00:00,0,null,267,267,267,31,0,0,34,3,37
20200312,NE,10,80,33,2020-03-12 20:00:00,null,null,123,90,90,31,0,0,33,5,38
20200317,NE,21,206,null,2020-03-17 20:00:00,null,null,227,227,227,31,0,0,36,3,39
20200329,NE,108,1968,4,2020-03-29 20:00:00,2,null,2080,2076,2076,31,0,0,64,12,76
20200316,NE,18,170,null,2020-03-16 20:00:00,null,null,188,188,188,31,0,0,90,1,91
20200321,NE,38,356,null,2020-03-21 20:00:00,0,null,394,394,394,31,0,0,116,6,122
20200328,NE,96,1904,null,2020-03-28 20:00:00,2,null,2000,2000,2000,31,2,0,143,11,154
20200327,NE,85,1761,null,2020-03-27 20:00:00,0,null,1846,1846,1846,31,0,0,177,12,189
20200413,NE,814,10158,null,2020-04-13 20:00:00,17,null,10972,10972,10972,31,0,0,258,23,281
20200326,NE,73,1584,null,2020-03-26 20:00:00,0,null,1657,1657,1657,31,0,0,280,12,292
20200422,NE,1722,14957,null,2020-04-22 20:00:00,38,null,16679,16679,16679,31,5,0,233,74,307
20200325,NE,61,1304,null,2020-03-25 20:00:00,0,null,1365,1365,1365,31,0,0,329,9,338
20200415,NE,901,10828,null,2020-04-15 20:00:00,20,null,11729,11729,11729,31,2,0,342,30,372
20200331,NE,172,2931,8,2020-03-31 20:00:00,3,null,3111,3103,3103,31,1,0,347,27,374
20200414,NE,871,10486,null,2020-04-14 20:00:00,18,null,11357,11357,11357,31,1,0,328,57,385
20200407,NE,447,6811,null,2020-04-07 20:00:00,10,null,7258,7258,7258,31,2,0,433,38,471
20200402,NE,246,3978,11,2020-04-02 20:00:00,5,null,4235,4224,4224,31,1,0,503,36,539
20200405,NE,363,5558,12,2020-04-05 20:00:00,8,null,5933,5921,5921,31,2,0,500,42,542
20200403,NE,279,4487,11,2020-04-03 20:00:00,6,null,4777,4766,4766,31,1,0,509,33,542
20200416,NE,952,11342,null,2020-04-16 20:00:00,21,null,12294,12294,12294,31,1,0,514,51,565
20200418,NE,1138,12539,null,2020-04-18 20:00:00,24,null,13677,13677,13677,31,0,0,501,72,573
20200401,NE,210,3475,8,2020-04-01 20:00:00,4,null,3693,3685,3685,31,1,0,544,38,582
20200404,NE,321,5058,10,2020-04-04 20:00:00,6,null,5389,5379,5379,31,0,0,571,42,613
20200324,NE,52,975,null,2020-03-24 20:00:00,0,null,1027,1027,1027,31,0,0,619,2,621
20200411,NE,700,9285,null,2020-04-11 20:00:00,17,null,9985,9985,9985,31,2,0,566,65,631
20200330,NE,145,2584,5,2020-03-30 20:00:00,2,null,2734,2729,2729,31,0,0,616,37,653
20200511,NE,8315,37924,null,2020-05-11 20:00:00,98,null,46239,46239,46239,31,2,0,589,81,670
20200410,NE,635,8719,null,2020-04-10 20:00:00,15,null,9354,9354,9354,31,1,0,603,68,671
20200423,NE,1813,15547,null,2020-04-23 20:00:00,45,null,17360,17360,17360,31,7,0,590,91,681
20200421,NE,1648,14724,null,2020-04-21 20:00:00,33,null,16372,16372,16372,31,5,0,518,174,692
20200408,NE,519,7442,null,2020-04-08 20:00:00,12,null,7961,7961,7961,31,2,0,631,72,703
20200412,NE,791,9900,null,2020-04-12 20:00:00,17,null,10691,10691,10691,31,0,0,615,91,706
20200409,NE,567,8116,null,2020-04-09 20:00:00,14,null,8683,8683,8683,31,2,0,674,48,722
20200417,NE,1066,12038,null,2020-04-17 20:00:00,24,null,13104,13104,13104,31,3,0,696,114,810
20200505,NE,6083,28526,null,2020-05-05 20:00:00,78,null,34609,34609,34609,31,0,0,682,173,855
20200406,NE,409,6378,8,2020-04-06 20:00:00,8,null,6795,6787,6787,31,0,0,820,46,866
20200419,NE,1287,13288,null,2020-04-19 20:00:00,28,null,14575,14575,14575,31,4,0,749,149,898
20200420,NE,1474,14206,null,2020-04-20 20:00:00,28,null,15680,15680,15680,31,0,0,918,187,1105
20200427,NE,3028,19335,null,2020-04-27 20:00:00,56,null,22363,22363,22363,31,3,0,839,296,1135
20200428,NE,3358,20247,null,2020-04-28 20:00:00,55,null,23605,23605,23605,31,-1,0,912,330,1242
20200424,NE,2124,16488,null,2020-04-24 20:00:00,47,null,18612,18612,18612,31,2,0,941,311,1252
20200426,NE,2732,18496,null,2020-04-26 20:00:00,53,null,21228,21228,21228,31,3,0,944,311,1255
20200425,NE,2421,17552,null,2020-04-25 20:00:00,50,null,19973,19973,19973,31,3,0,1064,297,1361
20200506,NE,6438,29690,null,2020-05-06 20:00:00,82,null,36128,36128,36128,31,4,0,1164,355,1519
20200507,NE,6771,30987,null,2020-05-07 20:00:00,86,null,37758,37758,37758,31,4,0,1297,333,1630
20200430,NE,3784,21537,null,2020-04-30 20:00:00,68,null,25321,25321,25321,31,13,0,1280,410,1690
20200503,NE,5326,25936,null,2020-05-03 20:00:00,76,null,31262,31262,31262,31,3,0,1426,488,1914
20200502,NE,4838,24510,null,2020-05-02 20:00:00,73,null,29348,29348,29348,31,3,0,1406,557,1963
20200501,NE,4281,23104,null,2020-05-01 20:00:00,70,null,27385,27385,27385,31,2,0,1567,497,2064
20200504,NE,5910,27844,null,2020-05-04 20:00:00,78,null,33754,33754,33754,31,2,0,1908,584,2492
20200509,NE,7831,35145,null,2020-05-09 20:00:00,92,null,42976,42976,42976,31,2,0,1923,641,2564
20200510,NE,8234,37335,null,2020-05-10 20:00:00,96,null,45569,45569,45569,31,4,0,2190,403,2593
20200508,NE,7190,33222,null,2020-05-08 20:00:00,90,null,40412,40412,40412,31,4,0,2235,419,2654
20200305,NE,0,17,5,2020-03-05 21:00:00,null,null,22,17,17,31,null,null,null,null,null
20200504,NH,2588,24282,244,2020-05-04 20:00:00,86,286,27114,26870,26870,33,2,9,-1682,159,-1523
20200505,NH,2588,24282,79,2020-05-05 20:00:00,86,286,26949,26870,26870,33,0,0,0,0,0
20200416,NH,1139,11027,121,2020-04-16 20:00:00,32,178,12287,12166,12166,33,0,0,0,0,0
20200316,NH,13,271,95,2020-03-16 20:00:00,null,null,379,284,284,33,0,0,0,0,0
20200313,NH,6,94,21,2020-03-13 20:00:00,null,null,121,100,100,33,0,0,0,0,0
20200311,NH,4,38,5,2020-03-11 20:00:00,null,null,47,42,42,33,0,0,0,0,0
20200310,NH,4,38,5,2020-03-10 20:00:00,null,null,47,42,42,33,0,0,0,0,0
20200309,NH,4,38,5,2020-03-09 20:00:00,null,null,47,42,42,33,0,0,0,0,0
20200307,NH,2,20,3,2020-03-07 21:00:00,null,null,25,22,22,33,0,0,0,0,0
20200306,NH,2,20,3,2020-03-06 21:00:00,null,null,25,22,22,33,0,0,4,0,4
20200305,NH,2,16,4,2020-03-05 21:00:00,null,null,22,18,18,33,0,0,6,0,6
20200308,NH,4,38,5,2020-03-08 20:00:00,null,null,47,42,42,33,0,0,18,2,20
20200331,NH,314,5413,65,2020-03-31 20:00:00,3,45,5792,5727,5727,33,0,0,27,0,27
20200312,NH,6,94,21,2020-03-12 20:00:00,null,null,121,100,100,33,0,0,56,2,58
20200315,NH,13,271,95,2020-03-15 20:00:00,null,null,379,284,284,33,0,0,59,6,65
20200317,NH,17,355,195,2020-03-17 20:00:00,null,null,567,372,372,33,0,0,84,4,88
20200402,NH,415,6078,126,2020-04-02 20:00:00,4,58,6619,6493,6493,33,0,2,93,0,93
20200324,NH,101,1447,869,2020-03-24 20:00:00,1,11,2417,1548,1548,33,1,11,73,23,96
20200314,NH,7,212,31,2020-03-14 20:00:00,null,null,250,219,219,33,0,0,118,1,119
20200319,NH,39,621,231,2020-03-19 20:00:00,null,null,891,660,660,33,0,0,108,13,121
20200501,NH,2146,19903,302,2020-05-01 20:00:00,72,262,22351,22049,22049,33,6,3,36,92,128
20200320,NH,44,745,631,2020-03-20 20:00:00,null,null,1420,789,789,33,0,0,124,5,129
20200418,NH,1287,11565,174,2020-04-18 20:00:00,37,190,13026,12852,12852,33,0,0,144,0,144
20200318,NH,26,513,208,2020-03-18 20:00:00,null,null,747,539,539,33,0,0,158,9,167
20200323,NH,78,1374,889,2020-03-23 20:00:00,null,null,2341,1452,1452,33,0,0,186,13,199
20200421,NH,1491,12848,244,2020-04-21 20:00:00,42,206,14583,14339,14339,33,1,8,122,99,221
20200322,NH,65,1188,959,2020-03-22 20:00:00,null,null,2212,1253,1253,33,0,0,215,10,225
20200321,NH,55,973,942,2020-03-21 20:00:00,null,null,1970,1028,1028,33,0,0,228,11,239
20200413,NH,985,10222,125,2020-04-13 20:00:00,23,152,11332,11207,11207,33,0,6,226,56,282
20200328,NH,187,3656,296,2020-03-28 20:00:00,2,30,4139,3843,3843,33,1,5,261,29,290
20200406,NH,669,7701,101,2020-04-06 20:00:00,9,92,8471,8370,8370,33,0,6,290,48,338
20200407,NH,715,8019,49,2020-04-07 20:00:00,9,103,8783,8734,8734,33,0,11,318,46,364
20200409,NH,788,8763,143,2020-04-09 20:00:00,18,118,9694,9551,9551,33,0,0,374,0,374
20200414,NH,1020,10590,25,2020-04-14 20:00:00,23,152,11635,11610,11610,33,0,0,368,35,403
20200410,NH,819,9139,155,2020-04-10 20:00:00,21,124,10113,9958,9958,33,3,6,376,31,407
20200327,NH,158,3395,592,2020-03-27 20:00:00,1,25,4145,3553,3553,33,0,6,394,21,415
20200428,NH,1938,18207,223,2020-04-28 20:00:00,60,246,20368,20145,20145,33,0,4,347,74,421
20200412,NH,929,9996,119,2020-04-12 20:00:00,23,146,11044,10925,10925,33,1,12,388,44,432
20200408,NH,788,8389,89,2020-04-08 20:00:00,18,118,9266,9177,9177,33,9,15,370,73,443
20200404,NH,540,6965,94,2020-04-04 20:00:00,7,80,7599,7505,7505,33,2,7,390,61,451
20200405,NH,621,7411,93,2020-04-05 20:00:00,9,86,8125,8032,8032,33,2,6,446,81,527
20200411,NH,885,9608,93,2020-04-11 20:00:00,22,134,10586,10493,10493,33,1,10,469,66,535
20200417,NH,1287,11421,174,2020-04-17 20:00:00,37,190,12882,12708,12708,33,5,12,394,148,542
20200415,NH,1139,11027,121,2020-04-15 20:00:00,32,178,12287,12166,12166,33,9,26,437,119,556
20200403,NH,479,6575,114,2020-04-03 20:00:00,5,73,7168,7054,7054,33,1,15,497,64,561
20200419,NH,1342,12082,316,2020-04-19 20:00:00,38,192,13740,13424,13424,33,1,2,517,55,572
20200429,NH,2010,18736,81,2020-04-29 20:00:00,60,249,20827,20746,20746,33,0,3,529,72,601
20200401,NH,415,5985,97,2020-04-01 20:00:00,4,56,6497,6400,6400,33,1,11,572,101,673
20200326,NH,137,3001,712,2020-03-26 20:00:00,1,19,3850,3138,3138,33,0,6,645,29,674
20200420,NH,1392,12726,298,2020-04-20 20:00:00,41,198,14416,14118,14118,33,3,6,644,50,694
20200422,NH,1491,13550,225,2020-04-22 20:00:00,42,206,15266,15041,15041,33,0,0,702,0,702
20200424,NH,1670,15139,424,2020-04-24 20:00:00,51,218,17233,16809,16809,33,3,5,715,82,797
20200506,NH,2636,25097,79,2020-05-06 20:00:00,92,295,27812,27733,27733,33,6,9,815,48,863
20200329,NH,214,4524,285,2020-03-29 20:00:00,2,33,5023,4738,4738,33,0,3,868,27,895
20200325,NH,108,2356,804,2020-03-25 20:00:00,1,13,3268,2464,2464,33,0,2,909,7,916
20200425,NH,1720,16007,398,2020-04-25 20:00:00,53,224,18125,17727,17727,33,2,6,868,50,918
20200330,NH,314,5386,144,2020-03-30 20:00:00,3,45,5844,5700,5700,33,1,12,862,100,962
20200423,NH,1588,14424,265,2020-04-23 20:00:00,48,213,16277,16012,16012,33,6,7,874,97,971
20200427,NH,1864,17860,270,2020-04-27 20:00:00,60,242,19994,19724,19724,33,0,4,896,77,973
20200426,NH,1787,16964,550,2020-04-26 20:00:00,60,238,19301,18751,18751,33,7,14,957,67,1024
20200507,NH,2740,26066,345,2020-05-07 20:00:00,111,307,29151,28806,28806,33,19,12,969,104,1073
20200510,NH,3011,30442,512,2020-05-10 20:00:00,131,313,33965,33453,33453,33,10,4,1091,64,1155
20200430,NH,2054,19867,272,2020-04-30 20:00:00,66,259,22193,21921,21921,33,6,10,1131,44,1175
20200511,NH,3160,31723,261,2020-05-11 20:00:00,133,318,35144,34883,34883,33,2,5,1281,149,1430
20200509,NH,2947,29351,304,2020-05-09 20:00:00,121,309,32602,32298,32298,33,7,1,1522,104,1626
20200508,NH,2843,27829,532,2020-05-08 20:00:00,114,308,31204,30672,30672,33,3,1,1763,103,1866
20200502,NH,2310,22039,159,2020-05-02 20:00:00,81,270,24508,24349,24349,33,9,8,2136,164,2300
20200503,NH,2429,25964,220,2020-05-03 20:00:00,84,277,28613,28393,28393,33,3,7,3925,119,4044
20200304,NH,2,10,7,2020-03-04 21:00:00,null,null,19,12,12,33,null,null,null,null,null
20200314,NJ,50,97,80,2020-03-14 20:00:00,1,null,227,147,147,34,0,0,0,0,0
20200306,NJ,1,null,null,2020-03-06 21:00:00,null,null,1,1,1,34,0,0,0,0,0
20200307,NJ,4,null,1,2020-03-07 21:00:00,null,null,5,4,4,34,0,0,0,3,3
20200309,NJ,11,35,14,2020-03-09 20:00:00,null,null,60,46,46,34,0,0,4,5,9
20200310,NJ,15,44,20,2020-03-10 20:00:00,null,null,79,59,59,34,0,0,9,4,13
20200311,NJ,24,57,20,2020-03-11 20:00:00,1,null,101,81,81,34,1,0,13,9,22
20200312,NJ,30,74,20,2020-03-12 20:00:00,1,null,124,104,104,34,0,0,17,6,23
20200308,NJ,6,31,0,2020-03-08 20:00:00,null,null,37,37,37,34,0,0,31,2,33
20200313,NJ,50,97,80,2020-03-13 20:00:00,1,null,227,147,147,34,0,0,23,20,43
20200315,NJ,98,120,34,2020-03-15 20:00:00,2,null,252,218,218,34,1,0,23,48,71
20200316,NJ,178,120,20,2020-03-16 20:00:00,2,null,318,298,298,34,0,0,0,80,80
20200317,NJ,267,163,55,2020-03-17 20:00:00,3,null,485,430,430,34,1,0,43,89,132
20200318,NJ,427,190,21,2020-03-18 20:00:00,5,null,638,617,617,34,2,0,27,160,187
20200320,NJ,890,264,86,2020-03-20 20:00:00,11,null,1240,1154,1154,34,2,0,54,148,202
20200319,NJ,742,210,74,2020-03-19 20:00:00,9,null,1026,952,952,34,4,0,20,315,335
20200321,NJ,1327,294,40,2020-03-21 20:00:00,16,null,1661,1621,1621,34,5,0,30,437,467
20200322,NJ,1914,327,49,2020-03-22 20:00:00,20,null,2290,2241,2241,34,4,0,33,587,620
20200323,NJ,2844,359,94,2020-03-23 20:00:00,27,null,3297,3203,3203,34,7,0,32,930,962
20200506,NJ,131890,157030,594,2020-05-06 20:00:00,8549,null,289514,288920,288920,34,305,0,0,1297,1297
20200504,NJ,128269,148951,647,2020-05-04 20:00:00,7910,null,277867,277220,277220,34,39,0,629,1525,2154
20200413,NJ,64584,64885,null,2020-04-13 20:00:00,2443,null,129469,129469,129469,34,93,0,0,2734,2734
20200325,NJ,4402,10452,null,2020-03-25 20:00:00,62,null,14854,14854,14854,34,18,0,2127,727,2854
20200507,NJ,133635,159023,552,2020-05-07 20:00:00,8801,null,293210,292658,292658,34,252,0,1993,1745,3738
20200331,NJ,18696,27077,null,2020-03-31 20:00:00,267,null,45773,45773,45773,34,69,0,1853,2060,3913
20200415,NJ,71030,72991,null,2020-04-15 20:00:00,3156,null,144021,144021,144021,34,351,0,2041,2206,4247
20200427,NJ,111188,116587,null,2020-04-27 20:00:00,6044,null,227775,227775,227775,34,106,0,2481,2150,4631
20200327,NJ,8825,16547,null,2020-03-27 20:00:00,108,null,25372,25372,25372,34,27,0,2886,1949,4835
20200418,NJ,81420,81116,null,2020-04-18 20:00:00,4070,null,162536,162536,162536,34,230,0,2134,2953,5087
20200329,NJ,13386,22216,null,2020-03-29 20:00:00,161,null,35602,35602,35602,34,21,0,2830,2262,5092
20200328,NJ,11124,19386,null,2020-03-28 20:00:00,140,null,30510,30510,30510,34,32,0,2839,2299,5138
20200408,NJ,47437,52979,null,2020-04-08 20:00:00,1504,null,100416,100416,100416,34,272,0,2421,3021,5442
20200417,NJ,78467,78982,null,2020-04-17 20:00:00,3840,null,157449,157449,157449,34,322,0,2469,3150,5619
20200326,NJ,6876,13661,null,2020-03-26 20:00:00,81,null,20537,20537,20537,34,19,0,3209,2474,5683
20200502,NJ,123717,138595,676,2020-05-02 20:00:00,7742,null,262988,262312,262312,34,204,0,3240,2527,5767
20200424,NJ,102196,103766,null,2020-04-24 20:00:00,5617,null,205962,205962,205962,34,249,0,3607,2207,5814
20200407,NJ,44416,50558,null,2020-04-07 20:00:00,1232,null,94974,94974,94974,34,229,0,2616,3326,5942
20200508,NJ,135454,163305,553,2020-05-08 20:00:00,8952,null,299312,298759,298759,34,151,0,4282,1819,6101
20200330,NJ,16636,25224,null,2020-03-30 20:00:00,198,null,41860,41860,41860,34,37,0,3008,3250,6258
20200410,NJ,54588,58935,null,2020-04-10 20:00:00,1932,null,113523,113523,113523,34,232,0,2770,3561,6331
20200509,NJ,137085,168121,557,2020-05-09 20:00:00,9116,null,305763,305206,305206,34,164,0,4816,1631,6447
20200402,NJ,25590,33520,null,2020-04-02 20:00:00,537,null,59110,59110,59110,34,182,0,3133,3335,6468
20200412,NJ,61850,64885,null,2020-04-12 20:00:00,2350,null,126735,126735,126735,34,167,0,2843,3699,6542
20200428,NJ,113856,120503,null,2020-04-28 20:00:00,6442,null,234359,234359,234359,34,398,0,3916,2668,6584
20200430,NJ,118652,129266,478,2020-04-30 20:00:00,7228,null,248396,247918,247918,34,458,0,4212,2388,6600
20200411,NJ,58151,62042,null,2020-04-11 20:00:00,2183,null,120193,120193,120193,34,251,0,3107,3563,6670
20200421,NJ,92387,92439,null,2020-04-21 20:00:00,4753,null,184826,184826,184826,34,376,0,3188,3581,6769
20200409,NJ,51027,56165,null,2020-04-09 20:00:00,1700,null,107192,107192,107192,34,196,0,3186,3590,6776
20200405,NJ,37505,44661,null,2020-04-05 20:00:00,917,null,82166,82166,82166,34,71,0,3429,3381,6810
20200422,NJ,95865,95794,null,2020-04-22 20:00:00,5063,null,191659,191659,191659,34,310,0,3355,3478,6833
20200406,NJ,41090,47942,null,2020-04-06 20:00:00,1003,null,89032,89032,89032,34,86,0,3281,3585,6866
20200401,NJ,22255,30387,null,2020-04-01 20:00:00,355,null,52642,52642,52642,34,88,0,3310,3559,6869
20200429,NJ,116264,125054,617,2020-04-29 20:00:00,6770,null,241935,241318,241318,34,328,0,4551,2408,6959
20200510,NJ,138532,173915,591,2020-05-10 20:00:00,9255,null,313038,312447,312447,34,139,0,5794,1447,7241
20200420,NJ,88806,89251,null,2020-04-20 20:00:00,4377,null,178057,178057,178057,34,175,0,3864,3505,7369
20200425,NJ,105523,108163,null,2020-04-25 20:00:00,5863,null,213686,213686,213686,34,246,0,4397,3327,7724
20200416,NJ,75317,76513,null,2020-04-16 20:00:00,3518,null,151830,151830,151830,34,362,0,3522,4287,7809
20200404,NJ,34124,41232,null,2020-04-04 20:00:00,846,null,75356,75356,75356,34,200,0,3624,4229,7853
20200419,NJ,85301,85387,null,2020-04-19 20:00:00,4202,null,170688,170688,170688,34,132,0,4271,3881,8152
20200403,NJ,29895,37608,null,2020-04-03 20:00:00,646,null,67503,67503,67503,34,109,0,4088,4305,8393
20200423,NJ,99989,100159,null,2020-04-23 20:00:00,5368,null,200148,200148,200148,34,305,0,4365,4124,8489
20200501,NJ,121190,135355,583,2020-05-01 20:00:00,7538,null,257128,256545,256545,34,310,0,6089,2538,8627
20200324,NJ,3675,8325,45,2020-03-24 20:00:00,44,null,12045,12000,12000,34,17,0,7966,831,8797
20200426,NJ,109038,114106,null,2020-04-26 20:00:00,5938,null,223144,223144,223144,34,75,0,5943,3515,9458
20200414,NJ,68824,70950,null,2020-04-14 20:00:00,2805,null,139774,139774,139774,34,362,0,6065,4240,10305
20200505,NJ,130593,157030,550,2020-05-05 20:00:00,8244,null,288173,287623,287623,34,334,0,8079,2324,10403
20200503,NJ,126744,148322,641,2020-05-03 20:00:00,7871,null,275707,275066,275066,34,129,0,9727,3027,12754
20200511,NJ,139945,285988,null,2020-05-11 20:00:00,9310,null,425933,425933,425933,34,55,0,112073,1413,113486
20200305,NJ,1,null,null,2020-03-05 21:00:00,null,null,1,1,1,34,null,null,null,null,null
20200411,NM,1091,26007,null,2020-04-11 20:00:00,19,null,27098,27098,27098,35,0,0,0,0,0
20200308,NM,0,48,0,2020-03-08 20:00:00,null,null,48,48,48,35,0,0,0,0,0
20200309,NM,0,57,0,2020-03-09 20:00:00,null,null,57,57,57,35,0,0,9,0,9
20200310,NM,0,69,null,2020-03-10 20:00:00,null,null,69,69,69,35,0,0,12,0,12
20200321,NM,57,3771,null,2020-03-21 20:00:00,null,null,3828,3828,3828,35,0,0,0,14,14
20200311,NM,3,87,null,2020-03-11 20:00:00,null,null,90,90,90,35,0,0,18,3,21
20200307,NM,0,48,0,2020-03-07 21:00:00,null,null,48,48,48,35,0,0,32,0,32
20200313,NM,10,190,null,2020-03-13 20:00:00,null,null,200,200,200,35,0,0,35,5,40
20200314,NM,10,237,null,2020-03-14 20:00:00,null,null,247,247,247,35,0,0,47,0,47
20200312,NM,5,155,null,2020-03-12 20:00:00,null,null,160,160,160,35,0,0,68,2,70
20200316,NM,17,566,null,2020-03-16 20:00:00,null,null,583,583,583,35,0,0,84,4,88
20200330,NM,237,10942,null,2020-03-30 20:00:00,2,null,11179,11179,11179,35,0,0,173,0,173
20200315,NM,13,482,null,2020-03-15 20:00:00,null,null,495,495,495,35,0,0,245,3,248
20200423,NM,2210,39022,null,2020-04-23 20:00:00,71,331,41232,41232,41232,35,6,25,217,138,355
20200420,NM,1845,35197,null,2020-04-20 20:00:00,55,274,37042,37042,37042,35,2,16,363,47,410
20200408,NM,794,21451,null,2020-04-08 20:00:00,13,null,22245,22245,22245,35,1,0,312,108,420
20200319,NM,35,2762,null,2020-03-19 20:00:00,null,null,2797,2797,2797,35,0,0,436,7,443
20200416,NM,1484,31910,null,2020-04-16 20:00:00,36,215,33394,33394,33394,35,0,34,467,77,544
20200324,NM,83,5890,null,2020-03-24 20:00:00,null,null,5973,5973,5973,35,0,0,569,18,587
20200323,NM,65,5321,null,2020-03-23 20:00:00,null,null,5386,5386,5386,35,0,0,599,8,607
20200317,NM,23,1249,null,2020-03-17 20:00:00,null,null,1272,1272,1272,35,0,0,683,6,689
20200401,NM,315,12925,null,2020-04-01 20:00:00,5,null,13240,13240,13240,35,1,0,679,34,713
20200327,NM,136,8377,null,2020-03-27 20:00:00,1,null,8513,8513,8513,35,0,0,696,24,720
20200403,NM,403,14375,null,2020-04-03 20:00:00,7,null,14778,14778,14778,35,1,0,727,40,767
20200402,NM,363,13648,null,2020-04-02 20:00:00,6,null,14011,14011,14011,35,1,0,723,48,771
20200404,NM,495,15137,null,2020-04-04 20:00:00,10,null,15632,15632,15632,35,3,0,762,92,854
20200325,NM,100,6742,null,2020-03-25 20:00:00,1,null,6842,6842,6842,35,1,0,852,17,869
20200328,NM,191,9196,null,2020-03-28 20:00:00,1,null,9387,9387,9387,35,0,0,819,55,874
20200415,NM,1407,31443,null,2020-04-15 20:00:00,36,181,32850,32850,32850,35,5,0,818,62,880
20200326,NM,112,7681,null,2020-03-26 20:00:00,1,null,7793,7793,7793,35,0,0,939,12,951
20200322,NM,57,4722,null,2020-03-22 20:00:00,null,null,4779,4779,4779,35,0,0,951,0,951
20200320,NM,43,3771,null,2020-03-20 20:00:00,null,null,3814,3814,3814,35,0,0,1009,8,1017
20200419,NM,1798,34834,null,2020-04-19 20:00:00,53,258,36632,36632,36632,35,2,16,932,87,1019
20200318,NM,28,2326,null,2020-03-18 20:00:00,null,null,2354,2354,2354,35,0,0,1077,5,1082
20200417,NM,1597,32891,null,2020-04-17 20:00:00,44,230,34488,34488,34488,35,8,15,981,113,1094
20200418,NM,1711,33902,null,2020-04-18 20:00:00,51,242,35613,35613,35613,35,7,12,1011,114,1125
20200405,NM,543,16285,null,2020-04-05 20:00:00,11,null,16828,16828,16828,35,1,0,1148,48,1196
20200331,NM,281,12246,null,2020-03-31 20:00:00,4,null,12527,12527,12527,35,2,0,1304,44,1348
20200414,NM,1345,30625,null,2020-04-14 20:00:00,31,181,31970,31970,31970,35,5,181,1355,100,1455
20200506,NM,4138,79113,null,2020-05-06 20:00:00,162,687,83251,83251,83251,35,6,20,1424,107,1531
20200409,NM,865,22942,null,2020-04-09 20:00:00,16,null,23807,23807,23807,35,3,0,1491,71,1562
20200412,NM,1174,27518,null,2020-04-12 20:00:00,20,null,28692,28692,28692,35,1,0,1511,83,1594
20200329,NM,237,10769,null,2020-03-29 20:00:00,2,null,11006,11006,11006,35,1,0,1573,46,1619
20200421,NM,1971,36784,null,2020-04-21 20:00:00,58,291,38755,38755,38755,35,3,17,1587,126,1713
20200413,NM,1245,29270,null,2020-04-13 20:00:00,26,null,30515,30515,30515,35,6,0,1752,71,1823
20200422,NM,2072,38805,null,2020-04-22 20:00:00,65,306,40877,40877,40877,35,7,15,2021,101,2122
20200428,NM,2823,55980,null,2020-04-28 20:00:00,104,481,58803,58803,58803,35,5,69,2091,97,2188
20200426,NM,2660,51075,null,2020-04-26 20:00:00,93,412,53735,53735,53735,35,9,0,2086,139,2225
20200406,NM,624,18512,null,2020-04-06 20:00:00,12,null,19136,19136,19136,35,1,0,2227,81,2308
20200507,NM,4291,81393,null,2020-05-07 20:00:00,169,687,85684,85684,85684,35,7,0,2280,153,2433
20200407,NM,686,21139,null,2020-04-07 20:00:00,12,null,21825,21825,21825,35,0,0,2627,62,2689
20200501,NM,3411,64458,null,2020-05-01 20:00:00,123,536,67869,67869,67869,35,11,0,2586,198,2784
20200427,NM,2726,53889,null,2020-04-27 20:00:00,99,412,56615,56615,56615,35,6,0,2814,66,2880
20200429,NM,2974,58771,null,2020-04-29 20:00:00,110,509,61745,61745,61745,35,6,28,2791,151,2942
20200504,NM,3850,74127,null,2020-05-04 20:00:00,151,587,77977,77977,77977,35,12,0,2915,118,3033
20200502,NM,3513,67605,null,2020-05-02 20:00:00,131,587,71118,71118,71118,35,8,51,3147,102,3249
20200410,NM,1091,26007,null,2020-04-10 20:00:00,19,null,27098,27098,27098,35,3,0,3065,226,3291
20200430,NM,3213,61872,null,2020-04-30 20:00:00,112,536,65085,65085,65085,35,2,27,3101,239,3340
20200508,NM,4493,84539,null,2020-05-08 20:00:00,172,760,89032,89032,89032,35,3,73,3146,202,3348
20200505,NM,4031,77689,null,2020-05-05 20:00:00,156,667,81720,81720,81720,35,5,80,3562,181,3743
20200510,NM,4778,92275,null,2020-05-10 20:00:00,191,789,97053,97053,97053,35,10,0,3686,105,3791
20200503,NM,3732,71212,null,2020-05-03 20:00:00,139,587,74944,74944,74944,35,8,0,3607,219,3826
20200509,NM,4673,88589,null,2020-05-09 20:00:00,181,789,93262,93262,93262,35,9,29,4050,180,4230
20200425,NM,2521,48989,null,2020-04-25 20:00:00,84,412,51510,51510,51510,35,6,45,4805,142,4947
20200424,NM,2379,44184,null,2020-04-24 20:00:00,78,367,46563,46563,46563,35,7,36,5162,169,5331
20200511,NM,4863,97635,null,2020-05-11 20:00:00,200,789,102498,102498,102498,35,9,0,5360,85,5445
20200306,NM,0,16,0,2020-03-06 21:00:00,null,null,16,16,16,35,null,null,null,null,null
20200318,NV,55,168,null,2020-03-18 20:00:00,1,null,223,223,223,32,0,0,0,0,0
20200310,NV,1,14,null,2020-03-10 20:00:00,null,null,15,15,15,32,0,0,0,0,0
20200309,NV,1,14,null,2020-03-09 20:00:00,null,null,15,15,15,32,0,0,0,0,0
20200308,NV,1,14,null,2020-03-08 20:00:00,null,null,15,15,15,32,0,0,0,0,0
20200307,NV,1,14,null,2020-03-07 21:00:00,null,null,15,15,15,32,0,0,0,0,0
20200306,NV,1,14,null,2020-03-06 21:00:00,null,null,15,15,15,32,0,0,0,0,0
20200315,NV,21,168,164,2020-03-15 20:00:00,null,null,353,189,189,32,0,0,0,1,1
20200312,NV,7,168,null,2020-03-12 20:00:00,null,null,175,175,175,32,0,0,0,2,2
20200313,NV,11,168,null,2020-03-13 20:00:00,null,null,179,179,179,32,0,0,0,4,4
20200314,NV,20,168,null,2020-03-14 20:00:00,null,null,188,188,188,32,0,0,0,9,9
20200317,NV,55,168,null,2020-03-17 20:00:00,1,null,223,223,223,32,0,0,0,10,10
20200316,NV,45,168,null,2020-03-16 20:00:00,1,null,213,213,213,32,1,0,0,24,24
20200322,NV,190,2448,null,2020-03-22 20:00:00,2,null,2638,2638,2638,32,0,0,64,66,130
20200311,NV,5,168,null,2020-03-11 20:00:00,null,null,173,173,173,32,0,0,154,4,158
20200325,NV,321,4251,null,2020-03-25 20:00:00,6,null,4572,4572,4572,32,2,0,297,43,340
20200320,NV,109,1992,null,2020-03-20 20:00:00,1,null,2101,2101,2101,32,0,0,366,14,380
20200321,NV,124,2384,null,2020-03-21 20:00:00,2,null,2508,2508,2508,32,1,0,392,15,407
20200403,NV,1514,13018,null,2020-04-03 20:00:00,43,null,14532,14532,14532,32,5,0,430,56,486
20200324,NV,278,3954,null,2020-03-24 20:00:00,4,null,4232,4232,4232,32,0,0,464,33,497
20200326,NV,420,4697,null,2020-03-26 20:00:00,10,null,5117,5117,5117,32,4,0,446,99,545
20200331,NV,1113,10681,null,2020-03-31 20:00:00,17,null,11794,11794,11794,32,2,0,474,105,579
20200427,NV,4690,34123,null,2020-04-27 20:00:00,206,null,38813,38813,38813,32,0,0,539,88,627
20200329,NV,738,8412,null,2020-03-29 20:00:00,14,null,9150,9150,9150,32,4,0,511,117,628
20200405,NV,1836,14995,null,2020-04-05 20:00:00,46,null,16831,16831,16831,32,0,0,574,94,668
20200421,NV,3937,29118,null,2020-04-21 20:00:00,163,null,33055,33055,33055,32,5,0,601,107,708
20200420,NV,3830,28517,null,2020-04-20 20:00:00,158,null,32347,32347,32347,32,3,0,647,102,749
20200502,NV,5311,39076,null,2020-05-02 20:00:00,254,null,44387,44387,44387,32,11,0,708,84,792
20200416,NV,3321,25130,null,2020-04-16 20:00:00,137,null,28451,28451,28451,32,6,0,686,110,796
20200406,NV,1953,15676,null,2020-04-06 20:00:00,46,null,17629,17629,17629,32,0,0,681,117,798
20200422,NV,4081,29807,null,2020-04-22 20:00:00,172,null,33888,33888,33888,32,9,0,689,144,833
20200411,NV,2700,20887,null,2020-04-11 20:00:00,102,null,23587,23587,23587,32,16,0,722,116,838
20200419,NV,3728,27870,null,2020-04-19 20:00:00,155,null,31598,31598,31598,32,4,0,745,102,847
20200413,NV,2971,22493,null,2020-04-13 20:00:00,114,null,25464,25464,25464,32,2,0,718,135,853
20200423,NV,4208,30541,null,2020-04-23 20:00:00,189,null,34749,34749,34749,32,17,0,734,127,861
20200503,NV,5426,39843,null,2020-05-03 20:00:00,257,null,45269,45269,45269,32,3,0,767,115,882
20200504,NV,5491,40675,null,2020-05-04 20:00:00,262,null,46166,46166,46166,32,5,0,832,65,897
20200429,NV,4898,36130,null,2020-04-29 20:00:00,230,null,41028,41028,41028,32,11,0,816,93,909
20200430,NV,4998,36988,null,2020-04-30 20:00:00,237,null,41986,41986,41986,32,7,0,858,100,958
20200426,NV,4602,33584,null,2020-04-26 20:00:00,206,null,38186,38186,38186,32,2,0,915,63,978
20200410,NV,2584,20165,null,2020-04-10 20:00:00,86,null,22749,22749,22749,32,6,0,850,128,978
20200418,NV,3626,27125,null,2020-04-18 20:00:00,151,null,30751,30751,30751,32,9,0,887,102,989
20200415,NV,3211,24444,null,2020-04-15 20:00:00,131,null,27655,27655,27655,32,11,0,871,123,994
20200401,NV,1279,11519,null,2020-04-01 20:00:00,26,null,12798,12798,12798,32,9,0,838,166,1004
20200407,NV,2087,16552,null,2020-04-07 20:00:00,58,null,18639,18639,18639,32,12,0,876,134,1010
20200425,NV,4539,32669,null,2020-04-25 20:00:00,204,null,37208,37208,37208,32,7,0,875,141,1016
20200412,NV,2836,21775,null,2020-04-12 20:00:00,112,null,24611,24611,24611,32,10,0,888,136,1024
20200323,NV,245,3490,null,2020-03-23 20:00:00,4,null,3735,3735,3735,32,2,0,1042,55,1097
20200414,NV,3088,23573,null,2020-04-14 20:00:00,120,null,26661,26661,26661,32,6,0,1080,117,1197
20200409,NV,2456,19315,null,2020-04-09 20:00:00,80,null,21771,21771,21771,32,9,0,1067,138,1205
20200402,NV,1458,12588,null,2020-04-02 20:00:00,38,null,14046,14046,14046,32,12,0,1069,179,1248
20200511,NV,6152,53932,null,2020-05-11 20:00:00,306,null,60084,60084,60084,32,0,0,1221,54,1275
20200428,NV,4805,35314,null,2020-04-28 20:00:00,219,null,40119,40119,40119,32,13,0,1191,115,1306
20200417,NV,3524,26238,null,2020-04-17 20:00:00,142,null,29762,29762,29762,32,5,0,1108,203,1311
20200506,NV,5663,43612,null,2020-05-06 20:00:00,276,null,49275,49275,49275,32,8,0,1322,69,1391
20200424,NV,4398,31794,null,2020-04-24 20:00:00,197,null,36192,36192,36192,32,8,0,1253,190,1443
20200319,NV,95,1626,null,2020-03-19 20:00:00,1,null,1721,1721,1721,32,0,0,1458,40,1498
20200327,NV,535,6161,null,2020-03-27 20:00:00,10,null,6696,6696,6696,32,0,0,1464,115,1579
20200501,NV,5227,38368,null,2020-05-01 20:00:00,243,null,43595,43595,43595,32,6,0,1380,229,1609
20200404,NV,1742,14421,null,2020-04-04 20:00:00,46,null,16163,16163,16163,32,3,0,1403,228,1631
20200505,NV,5594,42290,null,2020-05-05 20:00:00,268,null,47884,47884,47884,32,6,0,1615,103,1718
20200328,NV,621,7901,null,2020-03-28 20:00:00,10,null,8522,8522,8522,32,0,0,1740,86,1826
20200408,NV,2318,18248,null,2020-04-08 20:00:00,71,null,20566,20566,20566,32,13,0,1696,231,1927
20200508,NV,5884,47460,null,2020-05-08 20:00:00,293,null,53344,53344,53344,32,7,0,1869,118,1987
20200330,NV,1008,10207,null,2020-03-30 20:00:00,15,null,11215,11215,11215,32,1,0,1795,270,2065
20200507,NV,5766,45591,null,2020-05-07 20:00:00,286,null,51357,51357,51357,32,10,0,1979,103,2082
20200510,NV,6098,52711,null,2020-05-10 20:00:00,306,null,58809,58809,58809,32,5,0,2628,70,2698
20200509,NV,6028,50083,null,2020-05-09 20:00:00,301,null,56111,56111,56111,32,8,0,2623,144,2767
20200305,NV,1,14,null,2020-03-05 21:00:00,null,null,15,15,15,32,null,null,null,null,null
20200312,NY,216,92,null,2020-03-12 20:00:00,null,null,308,308,308,36,0,0,0,0,0
20200306,NY,33,92,236,2020-03-06 21:00:00,null,null,361,125,125,36,0,0,16,11,27
20200308,NY,105,92,null,2020-03-08 20:00:00,null,null,197,197,197,36,0,0,0,29,29
20200310,NY,173,92,null,2020-03-10 20:00:00,null,null,265,265,265,36,0,0,0,31,31
20200309,NY,142,92,null,2020-03-09 20:00:00,null,null,234,234,234,36,0,0,0,37,37
20200311,NY,216,92,null,2020-03-11 20:00:00,null,null,308,308,308,36,0,0,0,43,43
20200307,NY,76,92,236,2020-03-07 21:00:00,null,null,404,168,168,36,0,0,0,43,43
20200305,NY,22,76,24,2020-03-05 21:00:00,null,null,122,98,98,36,0,0,28,16,44
20200314,NY,524,2779,null,2020-03-14 20:00:00,null,null,3303,3303,3303,36,0,0,0,103,103
20200316,NY,950,4543,null,2020-03-16 20:00:00,7,null,5493,5493,5493,36,4,0,0,221,221
20200317,NY,1700,5506,null,2020-03-17 20:00:00,7,null,7206,7206,7206,36,0,0,963,750,1713
20200315,NY,729,4543,null,2020-03-15 20:00:00,3,null,5272,5272,5272,36,3,0,1764,205,1969
20200313,NY,421,2779,null,2020-03-13 20:00:00,null,null,3200,3200,3200,36,0,0,2687,205,2892
20200318,NY,2382,12215,null,2020-03-18 20:00:00,12,null,14597,14597,14597,36,5,0,6709,682,7391
20200319,NY,4152,18132,null,2020-03-19 20:00:00,12,null,22284,22284,22284,36,0,0,5917,1770,7687
20200320,NY,7102,25325,null,2020-03-20 20:00:00,35,null,32427,32427,32427,36,23,0,7193,2950,10143
20200328,NY,52318,103616,null,2020-03-28 20:00:00,728,10054,155934,155934,155934,36,209,1528,2498,7683,10181
20200325,NY,30811,72668,null,2020-03-25 20:00:00,285,3805,103479,103479,103479,36,75,571,7063,5146,12209
20200324,NY,25665,65605,null,2020-03-24 20:00:00,210,3234,91270,91270,91270,36,96,599,8191,4790,12981
20200321,NY,10356,35081,null,2020-03-21 20:00:00,44,1603,45437,45437,45437,36,9,1603,9756,3254,13010
20200330,NY,66497,119971,null,2020-03-30 20:00:00,1218,13721,186468,186468,186468,36,253,1646,7124,6984,14108
20200421,NY,251690,397635,null,2020-04-21 20:00:00,14828,56526,649325,649325,649325,36,481,1338,11286,4178,15464
20200401,NY,83712,137168,null,2020-04-01 20:00:00,1941,18368,220880,220880,220880,36,391,2464,7777,7917,15694
20200322,NY,15168,46233,null,2020-03-22 20:00:00,114,1974,61401,61401,61401,36,70,371,11152,4812,15964
20200420,NY,247512,386349,null,2020-04-20 20:00:00,14347,55188,633861,633861,633861,36,478,1379,11580,4726,16306
20200329,NY,59513,112847,null,2020-03-29 20:00:00,965,12075,172360,172360,172360,36,237,2021,9231,7195,16426
20200413,NY,195031,283326,null,2020-04-13 20:00:00,10056,42637,478357,478357,478357,36,671,43,10419,6337,16756
20200323,NY,20875,57414,null,2020-03-23 20:00:00,114,2635,78289,78289,78289,36,0,661,11181,5707,16888
20200402,NY,92381,146584,null,2020-04-02 20:00:00,2373,20817,238965,238965,238965,36,432,2449,9416,8669,18085
20200406,NY,130689,190122,null,2020-04-06 20:00:00,4758,30203,320811,320811,320811,36,599,2111,9873,8658,18531
20200326,NY,37258,84846,null,2020-03-26 20:00:00,385,6844,122104,122104,122104,36,100,3039,12178,6447,18625
20200405,NY,122031,180249,null,2020-04-05 20:00:00,4159,28092,302280,302280,302280,36,594,1709,10332,8327,18659
20200331,NY,75795,129391,null,2020-03-31 20:00:00,1550,15904,205186,205186,205186,36,332,2183,9420,9298,18718
20200428,NY,295106,549888,null,2020-04-28 20:00:00,17638,64318,844994,844994,844994,36,335,748,15789,3110,18899
20200407,NY,138863,201195,null,2020-04-07 20:00:00,5489,32083,340058,340058,340058,36,731,1880,11073,8174,19247
20200412,NY,188694,272907,null,2020-04-12 20:00:00,9385,42594,461601,461601,461601,36,758,1915,12385,8236,20621
20200422,NY,257216,412766,null,2020-04-22 20:00:00,15302,57907,669982,669982,669982,36,474,1381,15131,5526,20657
20200427,NY,291996,534099,null,2020-04-27 20:00:00,17303,63570,826095,826095,826095,36,337,1044,16794,3951,20745
20200414,NY,202208,296935,null,2020-04-14 20:00:00,10834,44286,499143,499143,499143,36,778,1649,13609,7177,20786
20200419,NY,242786,374769,null,2020-04-19 20:00:00,13869,53809,617555,617555,617555,36,507,1384,14969,6054,21023
20200504,NY,318953,688357,null,2020-05-04 20:00:00,19415,69331,1007310,1007310,1007310,36,226,595,18861,2538,21399
20200403,NY,102863,157657,null,2020-04-03 20:00:00,2935,23696,260520,260520,260520,36,562,2879,11073,10482,21555
20200505,NY,321192,707707,null,2020-05-05 20:00:00,19645,69867,1028899,1028899,1028899,36,230,536,19350,2239,21589
20200511,NY,337055,867596,null,2020-05-11 20:00:00,21640,73143,1204651,1204651,1204651,36,162,428,19993,1660,21653
20200417,NY,229642,343581,null,2020-04-17 20:00:00,12822,50508,573223,573223,573223,36,630,1973,15286,7358,22644
20200411,NY,180458,260522,null,2020-04-11 20:00:00,8627,40679,440980,440980,440980,36,783,1861,13149,9946,23095
20200404,NY,113704,169917,null,2020-04-04 20:00:00,3565,26383,283621,283621,283621,36,630,2687,12260,10841,23101
20200418,NY,236732,359800,null,2020-04-18 20:00:00,13362,52425,596532,596532,596532,36,540,1917,16219,7090,23309
20200327,NY,44635,101118,null,2020-03-27 20:00:00,519,8526,145753,145753,145753,36,134,1682,16272,7377,23649
20200416,NY,222284,328295,null,2020-04-16 20:00:00,12192,48535,550579,550579,550579,36,606,1996,16062,8505,24567
20200408,NY,149316,215837,null,2020-04-08 20:00:00,6268,34432,365153,365153,365153,36,779,2349,14642,10453,25095
20200423,NY,263460,432460,null,2020-04-23 20:00:00,15740,59265,695920,695920,695920,36,438,1358,19694,6244,25938
20200410,NY,170512,247373,null,2020-04-10 20:00:00,7844,38818,417885,417885,417885,36,777,2242,15761,10575,26336
20200409,NY,159937,231612,null,2020-04-09 20:00:00,7067,36576,391549,391549,391549,36,799,2144,15775,10621,26396
20200501,NY,308314,619124,null,2020-05-01 20:00:00,18610,67180,927438,927438,927438,36,289,811,22860,3942,26802
20200503,NY,316415,669496,null,2020-05-03 20:00:00,19189,68736,985911,985911,985911,36,280,846,23402,3438,26840
20200415,NY,213779,312233,null,2020-04-15 20:00:00,11586,46539,526012,526012,526012,36,752,2253,15298,11571,26869
20200506,NY,323978,731943,null,2020-05-06 20:00:00,19877,70539,1055921,1055921,1055921,36,232,672,24236,2786,27022
20200429,NY,299691,572790,null,2020-04-29 20:00:00,18015,65397,872481,872481,872481,36,377,1079,22902,4585,27487
20200426,NY,288045,517305,null,2020-04-26 20:00:00,16966,62526,805350,805350,805350,36,367,1067,21880,5902,27782
20200430,NY,304372,596264,null,2020-04-30 20:00:00,18321,66369,900636,900636,900636,36,306,972,23474,4681,28155
20200510,NY,335395,847603,null,2020-05-10 20:00:00,21478,72715,1182998,1182998,1182998,36,207,460,26957,2273,29230
20200508,NY,330407,791136,null,2020-05-08 20:00:00,21045,71679,1121543,1121543,1121543,36,217,527,28869,2758,31627
20200502,NY,312977,646094,null,2020-05-02 20:00:00,18909,67890,959071,959071,959071,36,299,710,26970,4663,31633
20200509,NY,333122,820646,null,2020-05-09 20:00:00,21271,72255,1153768,1153768,1153768,36,226,576,29510,2715,32225
20200507,NY,327649,762267,null,2020-05-07 20:00:00,20828,71152,1089916,1089916,1089916,36,951,613,30324,3671,33995
20200424,NY,271590,459066,null,2020-04-24 20:00:00,16162,60414,730656,730656,730656,36,422,1149,26606,8130,34736
20200425,NY,282143,495425,null,2020-04-25 20:00:00,16599,61459,777568,777568,777568,36,437,1045,36359,10553,46912
20200304,NY,6,48,24,2020-03-04 21:00:00,null,null,78,54,54,36,null,null,null,null,null
20200314,OH,13,50,159,2020-03-14 20:00:00,null,null,222,63,63,39,0,0,0,0,0
20200308,OH,0,10,4,2020-03-08 20:00:00,null,null,14,10,10,39,0,0,1,0,1
20200307,OH,0,9,5,2020-03-07 21:00:00,null,null,14,9,9,39,0,0,1,0,1
20200306,OH,0,8,2,2020-03-06 21:00:00,null,null,10,8,8,39,0,0,1,0,1
20200310,OH,3,14,15,2020-03-10 20:00:00,null,null,32,17,17,39,0,0,3,0,3
20200309,OH,3,11,5,2020-03-09 20:00:00,null,null,19,14,14,39,0,0,1,3,4
20200311,OH,4,21,24,2020-03-11 20:00:00,null,null,49,25,25,39,0,0,7,1,8
20200312,OH,5,30,52,2020-03-12 20:00:00,null,null,87,35,35,39,0,0,9,1,10
20200316,OH,50,140,361,2020-03-16 20:00:00,null,null,551,190,190,39,0,0,1,14,15
20200317,OH,67,140,null,2020-03-17 20:00:00,null,null,207,207,207,39,0,0,0,17,17
20200318,OH,88,140,null,2020-03-18 20:00:00,null,null,228,228,228,39,0,0,0,21,21
20200313,OH,13,50,159,2020-03-13 20:00:00,null,null,222,63,63,39,0,0,20,8,28
20200319,OH,119,140,null,2020-03-19 20:00:00,null,null,259,259,259,39,0,0,0,31,31
20200320,OH,169,140,null,2020-03-20 20:00:00,1,null,309,309,309,39,1,0,0,50,50
20200321,OH,247,140,null,2020-03-21 20:00:00,3,58,387,387,387,39,2,58,0,78,78
20200323,OH,442,140,null,2020-03-23 20:00:00,6,104,582,582,582,39,3,21,0,91,91
20200322,OH,351,140,null,2020-03-22 20:00:00,3,83,491,491,491,39,0,25,0,104,104
20200315,OH,36,139,350,2020-03-15 20:00:00,null,null,525,175,175,39,0,0,89,23,112
20200324,OH,564,140,null,2020-03-24 20:00:00,8,145,704,704,704,39,2,41,0,122,122
20200329,OH,1653,19012,null,2020-03-29 20:00:00,29,403,20665,20665,20665,39,4,59,0,247,247
20200328,OH,1406,19012,null,2020-03-28 20:00:00,25,344,20418,20418,20418,39,6,68,0,269,269
20200401,OH,2547,26992,null,2020-04-01 20:00:00,65,679,29539,29539,29539,39,10,94,0,348,348
20200418,OH,10222,68819,null,2020-04-18 20:00:00,451,2519,79041,79041,79041,39,33,95,0,1115,1115
20200413,OH,6975,58137,null,2020-04-13 20:00:00,274,2033,65112,65112,65112,39,21,85,1498,371,1869
20200405,OH,4043,39713,null,2020-04-05 20:00:00,119,1104,43756,43756,43756,39,17,98,1581,304,1885
20200411,OH,6250,54221,null,2020-04-11 20:00:00,247,1859,60471,60471,60471,39,16,104,1526,372,1898
20200331,OH,2199,26992,null,2020-03-31 20:00:00,55,585,29191,29191,29191,39,16,110,1650,266,1916
20200407,OH,4782,46056,null,2020-04-07 20:00:00,167,1354,50838,50838,50838,39,25,140,2128,332,2460
20200408,OH,5148,48193,null,2020-04-08 20:00:00,193,1495,53341,53341,53341,39,26,141,2137,366,2503
20200326,OH,867,16449,null,2020-03-26 20:00:00,15,223,17316,17316,17316,39,5,41,2389,163,2552
20200410,OH,5878,52695,null,2020-04-10 20:00:00,231,1755,58573,58573,58573,39,18,143,2222,366,2588
20200409,OH,5512,50473,null,2020-04-09 20:00:00,213,1612,55985,55985,55985,39,20,117,2280,364,2644
20200412,OH,6604,56639,null,2020-04-12 20:00:00,253,1948,63243,63243,63243,39,6,89,2418,354,2772
20200327,OH,1137,19012,null,2020-03-27 20:00:00,19,276,20149,20149,20149,39,4,53,2563,270,2833
20200414,OH,7280,60721,null,2020-04-14 20:00:00,324,2156,68001,68001,68001,39,50,123,2584,305,2889
20200427,OH,15699,103692,null,2020-04-27 20:00:00,753,3232,119391,119391,119391,39,25,54,3269,-264,3005
20200417,OH,9107,68819,null,2020-04-17 20:00:00,418,2424,77926,77926,77926,39,29,93,2393,693,3086
20200416,OH,8414,66426,null,2020-04-16 20:00:00,389,2331,74840,74840,74840,39,28,94,2665,623,3288
20200428,OH,16128,106578,null,2020-04-28 20:00:00,799,3340,122706,122706,122706,39,46,108,2886,429,3315
20200403,OH,3312,35063,null,2020-04-03 20:00:00,91,895,38375,38375,38375,39,10,93,3047,410,3457
20200404,OH,3739,38132,null,2020-04-04 20:00:00,102,1006,41871,41871,41871,39,11,111,3069,427,3496
20200420,OH,12919,77920,null,2020-04-20 20:00:00,509,2653,90839,90839,90839,39,38,88,2223,1317,3540
20200415,OH,7791,63761,null,2020-04-15 20:00:00,361,2237,71552,71552,71552,39,37,81,3040,511,3551
20200422,OH,14117,84389,null,2020-04-22 20:00:00,610,2882,98506,98506,98506,39,53,103,3400,392,3792
20200421,OH,13725,80989,null,2020-04-21 20:00:00,557,2779,94714,94714,94714,39,48,126,3069,806,3875
20200425,OH,15587,96396,null,2020-04-25 20:00:00,711,3115,111983,111983,111983,39,21,62,3868,418,4286
20200503,OH,19914,130252,null,2020-05-03 20:00:00,1038,3769,150166,150166,150166,39,17,57,3768,579,4347
20200423,OH,14694,88183,null,2020-04-23 20:00:00,656,2960,102877,102877,102877,39,46,78,3794,577,4371
20200426,OH,15963,100423,null,2020-04-26 20:00:00,728,3178,116386,116386,116386,39,17,63,4027,376,4403
20200406,OH,4450,43928,null,2020-04-06 20:00:00,142,1214,48378,48378,48378,39,23,110,4215,407,4622
20200424,OH,15169,92528,null,2020-04-24 20:00:00,690,3053,107697,107697,107697,39,34,93,4345,475,4820
20200430,OH,18027,115863,null,2020-04-30 20:00:00,975,3533,133890,133890,133890,39,38,112,4258,724,4982
20200504,OH,20474,134681,null,2020-05-04 20:00:00,1056,3809,155155,155155,155155,39,18,40,4429,560,4989
20200502,OH,19335,126484,null,2020-05-02 20:00:00,1021,3712,145819,145819,145819,39,19,78,4721,592,5313
20200402,OH,2902,32016,null,2020-04-02 20:00:00,81,802,34918,34918,34918,39,16,123,5024,355,5379
20200505,OH,20969,139766,null,2020-05-05 20:00:00,1135,3956,160735,160735,160735,39,79,147,5085,495,5580
20200511,OH,24777,185753,null,2020-05-11 20:00:00,1357,4413,210530,210530,210530,39,16,62,4972,696,5668
20200429,OH,17303,111605,null,2020-04-29 20:00:00,937,3421,128908,128908,128908,39,138,81,5027,1175,6202
20200330,OH,1933,25342,null,2020-03-30 20:00:00,39,475,27275,27275,27275,39,10,72,6330,280,6610
20200501,OH,18743,121763,null,2020-05-01 20:00:00,1002,3634,140506,140506,140506,39,27,101,5900,716,6616
20200507,OH,22131,153928,null,2020-05-07 20:00:00,1271,4140,176059,176059,176059,39,46,88,6575,555,7130
20200510,OH,24081,180781,null,2020-05-10 20:00:00,1341,4351,204862,204862,204862,39,10,51,7808,384,8192
20200506,OH,21576,147353,null,2020-05-06 20:00:00,1225,4052,168929,168929,168929,39,90,96,7587,607,8194
20200508,OH,23016,161300,null,2020-05-08 20:00:00,1306,4218,184316,184316,184316,39,35,78,7372,885,8257
20200419,OH,11602,75697,null,2020-04-19 20:00:00,471,2565,87299,87299,87299,39,20,46,6878,1380,8258
20200509,OH,23697,172973,null,2020-05-09 20:00:00,1331,4300,196670,196670,196670,39,25,82,11673,681,12354
20200325,OH,704,14060,null,2020-03-25 20:00:00,10,182,14764,14764,14764,39,2,37,13920,140,14060
20200305,OH,0,7,3,2020-03-05 21:00:00,null,null,10,7,7,39,null,null,null,null,null
20200313,OK,3,36,37,2020-03-13 20:00:00,null,null,76,39,39,40,0,0,0,0,0
20200311,OK,2,15,11,2020-03-11 20:00:00,null,null,28,17,17,40,0,0,0,0,0
20200309,OK,1,8,10,2020-03-09 20:00:00,null,null,19,9,9,40,0,0,0,0,0
20200314,OK,4,36,37,2020-03-14 20:00:00,null,null,77,40,40,40,0,0,0,1,1
20200310,OK,2,15,11,2020-03-10 20:00:00,null,null,28,17,17,40,0,0,7,1,8
20200308,OK,1,8,2,2020-03-08 20:00:00,null,null,11,9,9,40,0,0,8,0,8
20200312,OK,3,36,4,2020-03-12 20:00:00,null,null,43,39,39,40,0,0,21,1,22
20200511,OK,4613,91379,null,2020-05-11 20:00:00,274,828,95992,95992,95992,40,2,2,0,24,24
20200321,OK,53,560,144,2020-03-21 20:00:00,1,10,757,613,613,40,0,10,22,4,26
20200427,OK,3280,49891,null,2020-04-27 20:00:00,197,656,53171,53171,53171,40,2,3,0,27,27
20200419,OK,2599,32966,null,2020-04-19 20:00:00,140,541,35565,35565,35565,40,1,0,0,29,29
20200323,OK,81,694,102,2020-03-23 20:00:00,2,15,877,775,775,40,0,4,25,14,39
20200408,OK,1524,11821,null,2020-04-08 20:00:00,79,390,13345,13345,13345,40,12,14,0,52,52
20200330,OK,481,1207,null,2020-03-30 20:00:00,17,153,1688,1688,1688,40,1,13,2,52,54
20200316,OK,10,174,29,2020-03-16 20:00:00,null,null,213,184,184,40,0,0,56,1,57
20200426,OK,3253,49891,null,2020-04-26 20:00:00,195,653,53144,53144,53144,40,1,16,0,60,60
20200324,OK,106,735,null,2020-03-24 20:00:00,3,25,841,841,841,40,1,10,41,25,66
20200504,OK,4044,59804,null,2020-05-04 20:00:00,238,753,63848,63848,63848,40,0,10,0,72,72
20200329,OK,429,1205,null,2020-03-29 20:00:00,16,140,1634,1634,1634,40,1,14,25,52,77
20200320,OK,49,538,374,2020-03-20 20:00:00,1,null,961,587,587,40,0,0,72,5,77
20200317,OK,17,247,82,2020-03-17 20:00:00,null,null,346,264,264,40,0,0,73,7,80
20200420,OK,2680,32966,null,2020-04-20 20:00:00,143,541,35646,35646,35646,40,3,0,0,81,81
20200315,OK,9,118,12,2020-03-15 20:00:00,null,null,139,127,127,40,0,0,82,5,87
20200406,OK,1327,1422,null,2020-04-06 20:00:00,51,340,2749,2749,2749,40,5,10,21,75,96
20200510,OK,4589,91379,null,2020-05-10 20:00:00,272,826,95968,95968,95968,40,2,4,0,99,99
20200413,OK,2069,20790,null,2020-04-13 20:00:00,99,457,22859,22859,22859,40,3,11,0,99,99
20200412,OK,1970,20790,null,2020-04-12 20:00:00,96,446,22760,22760,22760,40,2,0,0,102,102
20200502,OK,3851,59804,null,2020-05-02 20:00:00,238,743,63655,63655,63655,40,8,28,0,103,103
20200319,OK,44,466,250,2020-03-19 20:00:00,1,null,760,510,510,40,1,0,88,15,103
20200424,OK,3121,43019,null,2020-04-24 20:00:00,188,637,46140,46140,46140,40,9,15,0,104,104
20200331,OK,565,1229,null,2020-03-31 20:00:00,23,177,1794,1794,1794,40,6,24,22,84,106
20200503,OK,3972,59804,null,2020-05-03 20:00:00,238,743,63776,63776,63776,40,0,0,0,121,121
20200423,OK,3017,43019,null,2020-04-23 20:00:00,179,622,46036,46036,46036,40,9,34,0,123,123
20200322,OK,67,669,102,2020-03-22 20:00:00,2,11,838,736,736,40,1,1,109,14,123
20200325,OK,164,805,null,2020-03-25 20:00:00,5,59,969,969,969,40,2,34,70,58,128
20200501,OK,3748,59804,null,2020-05-01 20:00:00,230,715,63552,63552,63552,40,8,12,0,130,130
20200405,OK,1252,1401,null,2020-04-05 20:00:00,46,330,2653,2653,2653,40,4,14,39,93,132
20200318,OK,29,378,110,2020-03-18 20:00:00,null,null,517,407,407,40,0,0,131,12,143
20200328,OK,377,1180,null,2020-03-28 20:00:00,15,126,1557,1557,1557,40,7,21,96,55,151
20200403,OK,988,1315,null,2020-04-03 20:00:00,38,289,2303,2303,2303,40,4,32,50,109,159
20200401,OK,719,1248,null,2020-04-01 20:00:00,30,219,1967,1967,1967,40,7,42,19,154,173
20200402,OK,879,1265,null,2020-04-02 20:00:00,34,257,2144,2144,2144,40,4,38,17,160,177
20200327,OK,322,1084,null,2020-03-27 20:00:00,8,105,1406,1406,1406,40,1,19,126,74,200
20200404,OK,1159,1362,null,2020-04-04 20:00:00,42,316,2521,2521,2521,40,4,27,47,171,218
20200326,OK,248,958,null,2020-03-26 20:00:00,7,86,1206,1206,1206,40,2,27,153,84,237
20200411,OK,1868,20790,null,2020-04-11 20:00:00,94,446,22658,22658,22658,40,6,18,420,74,494
20200415,OK,2263,26956,null,2020-04-15 20:00:00,123,510,29219,29219,29219,40,15,22,871,79,950
20200429,OK,3473,57794,null,2020-04-29 20:00:00,214,693,61267,61267,61267,40,7,37,1505,63,1568
20200422,OK,2894,43019,null,2020-04-22 20:00:00,170,588,45913,45913,45913,40,6,27,1482,87,1569
20200416,OK,2357,28542,null,2020-04-16 20:00:00,131,528,30899,30899,30899,40,8,18,1586,94,1680
20200410,OK,1794,20370,null,2020-04-10 20:00:00,88,428,22164,22164,22164,40,8,13,1775,110,1885
20200418,OK,2570,32966,null,2020-04-18 20:00:00,139,541,35536,35536,35536,40,3,13,1811,105,1916
20200430,OK,3618,59804,null,2020-04-30 20:00:00,222,703,63422,63422,63422,40,8,10,2010,145,2155
20200417,OK,2465,31155,null,2020-04-17 20:00:00,136,528,33620,33620,33620,40,5,0,2613,108,2721
20200508,OK,4424,85433,null,2020-05-08 20:00:00,266,805,89857,89857,89857,40,6,0,2876,94,2970
20200506,OK,4201,78689,null,2020-05-06 20:00:00,253,773,82890,82890,82890,40,6,0,3399,74,3473
20200507,OK,4330,82557,null,2020-05-07 20:00:00,260,805,86887,86887,86887,40,7,32,3868,129,3997
20200414,OK,2184,26085,null,2020-04-14 20:00:00,108,488,28269,28269,28269,40,9,31,5295,115,5410
20200509,OK,4490,91379,null,2020-05-09 20:00:00,270,822,95869,95869,95869,40,4,17,5946,66,6012
20200428,OK,3410,56289,null,2020-04-28 20:00:00,207,656,59699,59699,59699,40,10,0,6398,130,6528
20200409,OK,1684,18595,null,2020-04-09 20:00:00,80,415,20279,20279,20279,40,1,25,6774,160,6934
20200425,OK,3193,49891,null,2020-04-25 20:00:00,194,637,53084,53084,53084,40,6,0,6872,72,6944
20200421,OK,2807,41537,null,2020-04-21 20:00:00,164,561,44344,44344,44344,40,21,20,8571,127,8698
20200407,OK,1472,11821,null,2020-04-07 20:00:00,67,376,13293,13293,13293,40,16,36,10399,145,10544
20200505,OK,4127,75290,null,2020-05-05 20:00:00,247,773,79417,79417,79417,40,9,20,15486,83,15569
20200307,OK,1,null,null,2020-03-07 21:00:00,null,null,1,1,1,40,null,null,null,null,null
20200428,OR,2354,48844,null,2020-04-28 20:00:00,92,554,51198,51198,51198,41,0,0,0,0,0
20200410,OR,1321,24306,null,2020-04-10 20:00:00,44,326,25627,25627,25627,41,0,0,0,0,0
20200325,OR,209,4350,null,2020-03-25 20:00:00,8,61,4559,4559,4559,41,0,0,0,0,0
20200321,OR,114,2003,433,2020-03-21 20:00:00,3,null,2550,2117,2117,41,0,0,0,0,0
20200314,OR,30,337,157,2020-03-14 20:00:00,null,null,524,367,367,41,0,0,0,0,0
20200312,OR,19,286,62,2020-03-12 20:00:00,null,null,367,305,305,41,0,0,0,0,0
20200305,OR,3,45,13,2020-03-05 21:00:00,null,null,61,48,48,41,0,0,16,0,16
20200307,OR,7,77,40,2020-03-07 21:00:00,null,null,124,84,84,41,0,0,13,4,17
20200306,OR,3,64,28,2020-03-06 21:00:00,null,null,95,67,67,41,0,0,19,0,19
20200308,OR,14,100,53,2020-03-08 20:00:00,null,null,167,114,114,41,0,0,23,7,30
20200401,OR,736,13136,null,2020-04-01 20:00:00,18,154,13872,13872,13872,41,0,0,0,46,46
20200310,OR,15,213,67,2020-03-10 20:00:00,null,null,295,228,228,41,0,0,48,1,49
20200422,OR,2059,39126,null,2020-04-22 20:00:00,78,488,41185,41185,41185,41,0,17,0,57,57
20200313,OR,30,337,157,2020-03-13 20:00:00,null,null,524,367,367,41,0,0,51,11,62
20200309,OR,14,165,52,2020-03-09 20:00:00,null,null,231,179,179,41,0,0,65,0,65
20200311,OR,19,286,62,2020-03-11 20:00:00,null,null,367,305,305,41,0,0,73,4,77
20200315,OR,36,420,225,2020-03-15 20:00:00,null,null,681,456,456,41,0,0,83,6,89
20200404,OR,999,16535,null,2020-04-04 20:00:00,26,239,17534,17534,17534,41,4,35,0,100,100
20200317,OR,47,689,184,2020-03-17 20:00:00,null,null,920,736,736,41,0,0,110,8,118
20200316,OR,39,579,182,2020-03-16 20:00:00,null,null,800,618,618,41,0,0,159,3,162
20200319,OR,88,1329,437,2020-03-19 20:00:00,3,null,1854,1417,1417,41,0,0,211,13,224
20200318,OR,75,1118,361,2020-03-18 20:00:00,3,null,1554,1193,1193,41,3,0,429,28,457
20200320,OR,114,2003,433,2020-03-20 20:00:00,3,null,2550,2117,2117,41,0,0,674,26,700
20200324,OR,209,4350,null,2020-03-24 20:00:00,8,61,4559,4559,4559,41,3,5,701,18,719
20200323,OR,191,3649,null,2020-03-23 20:00:00,5,56,3840,3840,3840,41,1,13,785,30,815
20200510,OR,3228,72279,null,2020-05-10 20:00:00,127,670,75507,75507,75507,41,0,8,819,68,887
20200322,OR,161,2864,null,2020-03-22 20:00:00,4,43,3025,3025,3025,41,1,43,861,47,908
20200331,OR,690,13136,null,2020-03-31 20:00:00,18,154,13826,13826,13826,41,2,14,859,84,943
20200415,OR,1663,31688,null,2020-04-15 20:00:00,58,401,33351,33351,33351,41,3,20,958,30,988
20200420,OR,1956,38089,null,2020-04-20 20:00:00,75,465,40045,40045,40045,41,1,9,961,46,1007
20200409,OR,1321,24306,null,2020-04-09 20:00:00,44,326,25627,25627,25627,41,11,2,981,82,1063
20200421,OR,2002,39126,null,2020-04-21 20:00:00,78,471,41128,41128,41128,41,3,6,1037,46,1083
20200406,OR,1132,20669,null,2020-04-06 20:00:00,27,258,21801,21801,21801,41,0,0,1113,64,1177
20200407,OR,1181,21826,null,2020-04-07 20:00:00,33,324,23007,23007,23007,41,6,66,1157,49,1206
20200414,OR,1633,30730,null,2020-04-14 20:00:00,55,381,32363,32363,32363,41,2,12,1193,49,1242
20200328,OR,479,9693,null,2020-03-28 20:00:00,13,117,10172,10172,10172,41,1,15,1183,65,1248
20200329,OR,548,10878,null,2020-03-29 20:00:00,13,129,11426,11426,11426,41,0,12,1185,69,1254
20200418,OR,1844,35739,null,2020-04-18 20:00:00,72,449,37583,37583,37583,41,2,22,1203,59,1262
20200403,OR,899,16535,null,2020-04-03 20:00:00,22,204,17434,17434,17434,41,1,16,1276,73,1349
20200413,OR,1584,29537,null,2020-04-13 20:00:00,53,369,31121,31121,31121,41,1,10,1306,57,1363
20200417,OR,1785,34536,null,2020-04-17 20:00:00,70,427,36321,36321,36321,41,6,13,1334,49,1383
20200504,OR,2759,60698,null,2020-05-04 20:00:00,109,608,63457,63457,63457,41,0,10,1324,79,1403
20200419,OR,1910,37128,null,2020-04-19 20:00:00,74,456,39038,39038,39038,41,2,7,1389,66,1455
20200330,OR,606,12277,null,2020-03-30 20:00:00,16,140,12883,12883,12883,41,3,11,1399,58,1457
20200424,OR,2177,43315,null,2020-04-24 20:00:00,86,520,45492,45492,45492,41,3,8,1466,50,1516
20200408,OR,1239,23325,null,2020-04-08 20:00:00,33,324,24564,24564,24564,41,0,0,1499,58,1557
20200430,OR,2510,53522,null,2020-04-30 20:00:00,103,578,56032,56032,56032,41,2,9,1496,64,1560
20200426,OR,2311,46653,null,2020-04-26 20:00:00,91,546,48964,48964,48964,41,4,10,1529,58,1587
20200416,OR,1736,33202,null,2020-04-16 20:00:00,64,414,34938,34938,34938,41,6,13,1514,73,1587
20200411,OR,1371,25853,null,2020-04-11 20:00:00,48,338,27224,27224,27224,41,4,12,1547,50,1597
20200327,OR,414,8510,null,2020-03-27 20:00:00,12,102,8924,8924,8924,41,1,12,1557,87,1644
20200425,OR,2253,45124,null,2020-04-25 20:00:00,87,536,47377,47377,47377,41,1,16,1809,76,1885
20200503,OR,2680,59374,null,2020-05-03 20:00:00,109,598,62054,62054,62054,41,0,3,1873,45,1918
20200509,OR,3160,71460,null,2020-05-09 20:00:00,127,662,74620,74620,74620,41,3,3,1835,92,1927
20200502,OR,2635,57501,null,2020-05-02 20:00:00,109,595,60136,60136,60136,41,5,4,1904,56,1960
20200505,OR,2839,62585,null,2020-05-05 20:00:00,113,622,65424,65424,65424,41,4,14,1887,80,1967
20200511,OR,3286,74320,null,2020-05-11 20:00:00,130,673,77606,77606,77606,41,3,3,2041,58,2099
20200501,OR,2579,55597,null,2020-05-01 20:00:00,104,591,58176,58176,58176,41,1,13,2075,69,2144
20200402,OR,826,15259,null,2020-04-02 20:00:00,21,188,16085,16085,16085,41,3,34,2123,90,2213
20200427,OR,2354,48844,null,2020-04-27 20:00:00,92,554,51198,51198,51198,41,1,8,2191,43,2234
20200508,OR,3068,69625,null,2020-05-08 20:00:00,124,659,72693,72693,72693,41,3,14,2156,79,2235
20200507,OR,2989,67469,null,2020-05-07 20:00:00,121,645,70458,70458,70458,41,6,4,2409,73,2482
20200412,OR,1527,28231,null,2020-04-12 20:00:00,52,359,29758,29758,29758,41,4,21,2378,156,2534
20200506,OR,2916,65060,null,2020-05-06 20:00:00,115,641,67976,67976,67976,41,2,19,2475,77,2552
20200326,OR,327,6953,null,2020-03-26 20:00:00,11,90,7280,7280,7280,41,3,29,2603,118,2721
20200423,OR,2127,41849,null,2020-04-23 20:00:00,83,512,43976,43976,43976,41,5,24,2723,68,2791
20200405,OR,1068,19556,null,2020-04-05 20:00:00,27,258,20624,20624,20624,41,1,19,3021,69,3090
20200429,OR,2446,52026,null,2020-04-29 20:00:00,101,569,54472,54472,54472,41,9,15,3182,92,3274
20200304,OR,3,29,18,2020-03-04 21:00:00,null,null,50,32,32,41,null,null,null,null,null
20200310,PA,12,null,null,2020-03-10 20:00:00,null,null,12,12,12,42,0,0,0,2,2
20200308,PA,6,null,null,2020-03-08 20:00:00,null,null,6,6,6,42,0,0,0,2,2
20200307,PA,4,null,null,2020-03-07 21:00:00,null,null,4,4,4,42,0,0,0,2,2
20200309,PA,10,null,null,2020-03-09 20:00:00,null,null,10,10,10,42,0,0,0,4,4
20200315,PA,63,205,183,2020-03-15 20:00:00,null,null,451,268,268,42,0,0,0,16,16
20200312,PA,22,116,81,2020-03-12 20:00:00,null,null,219,138,138,42,0,0,28,6,34
20200313,PA,41,140,130,2020-03-13 20:00:00,null,null,311,181,181,42,0,0,24,19,43
20200314,PA,47,205,150,2020-03-14 20:00:00,null,null,402,252,252,42,0,0,65,6,71
20200311,PA,16,88,54,2020-03-11 20:00:00,null,null,158,104,104,42,0,0,88,4,92
20200317,PA,96,879,null,2020-03-17 20:00:00,null,null,975,975,975,42,0,0,209,20,229
20200318,PA,133,1187,null,2020-03-18 20:00:00,1,null,1320,1320,1320,42,1,0,308,37,345
20200319,PA,185,1608,null,2020-03-19 20:00:00,1,null,1793,1793,1793,42,0,0,421,52,473
20200316,PA,76,670,null,2020-03-16 20:00:00,null,null,746,746,746,42,0,0,465,13,478
20200320,PA,268,2574,null,2020-03-20 20:00:00,1,null,2842,2842,2842,42,0,0,966,83,1049
20200321,PA,371,3766,null,2020-03-21 20:00:00,2,null,4137,4137,4137,42,1,0,1192,103,1295
20200322,PA,479,4964,null,2020-03-22 20:00:00,2,null,5443,5443,5443,42,0,0,1198,108,1306
20200323,PA,644,6595,null,2020-03-23 20:00:00,6,null,7239,7239,7239,42,4,0,1631,165,1796
20200324,PA,851,8643,null,2020-03-24 20:00:00,7,null,9494,9494,9494,42,1,0,2048,207,2255
20200325,PA,1127,11193,null,2020-03-25 20:00:00,11,null,12320,12320,12320,42,4,0,2550,276,2826
20200414,PA,25345,108286,null,2020-04-14 20:00:00,584,null,133631,133631,133631,42,60,0,2693,1146,3839
20200416,PA,27735,113735,null,2020-04-16 20:00:00,707,null,141470,141470,141470,42,60,0,2641,1245,3886
20200421,PA,34528,132323,null,2020-04-21 20:00:00,1564,null,166851,166851,166851,42,360,0,2603,1296,3899
20200415,PA,26490,111094,null,2020-04-15 20:00:00,647,null,137584,137584,137584,42,63,0,2808,1145,3953
20200420,PA,33232,129720,null,2020-04-20 20:00:00,1204,null,162952,162952,162952,42,92,0,3150,948,4098
20200330,PA,4087,33777,null,2020-03-30 20:00:00,49,386,37864,37864,37864,42,11,33,3716,693,4409
20200511,PA,57154,231704,null,2020-05-11 20:00:00,3731,null,288858,288858,288858,42,24,0,3932,543,4475
20200331,PA,4843,37645,null,2020-03-31 20:00:00,63,514,42488,42488,42488,42,14,128,3868,756,4624
20200412,PA,22833,102057,null,2020-04-12 20:00:00,507,null,124890,124890,124890,42,13,0,3559,1178,4737
20200328,PA,2751,25254,null,2020-03-28 20:00:00,34,316,28005,28005,28005,42,12,75,4238,533,4771
20200427,PA,42050,161372,null,2020-04-27 20:00:00,1597,null,203422,203422,203422,42,47,0,3944,885,4829
20200419,PA,32284,126570,null,2020-04-19 20:00:00,1112,null,158854,158854,158854,42,276,0,3674,1215,4889
20200413,PA,24199,105593,null,2020-04-13 20:00:00,524,null,129792,129792,129792,42,17,0,3536,1366,4902
20200504,PA,50092,195498,null,2020-05-04 20:00:00,2458,null,245590,245590,245590,42,14,0,4124,825,4949
20200422,PA,35684,136272,null,2020-04-22 20:00:00,1622,null,171956,171956,171956,42,58,0,3949,1156,5105
20200327,PA,2218,21016,null,2020-03-27 20:00:00,22,241,23234,23234,23234,42,6,241,4575,531,5106
20200503,PA,49267,191374,null,2020-05-03 20:00:00,2444,null,240641,240641,240641,42,26,0,4303,962,5265
20200505,PA,50957,199925,null,2020-05-05 20:00:00,3012,null,250882,250882,250882,42,554,0,4427,865,5292
20200329,PA,3394,30061,null,2020-03-29 20:00:00,38,353,33455,33455,33455,42,4,37,4807,643,5450
20200506,PA,51845,204495,null,2020-05-06 20:00:00,3106,null,256340,256340,256340,42,94,0,4570,888,5458
20200426,PA,41165,157428,null,2020-04-26 20:00:00,1550,null,198593,198593,198593,42,13,0,4542,1116,5658
20200428,PA,43264,165824,null,2020-04-28 20:00:00,1716,null,209088,209088,209088,42,119,0,4452,1214,5666
20200401,PA,5805,42427,null,2020-04-01 20:00:00,74,620,48232,48232,48232,42,11,106,4782,962,5744
20200429,PA,44366,170517,null,2020-04-29 20:00:00,2195,null,214883,214883,214883,42,479,0,4693,1102,5795
20200326,PA,1687,16441,null,2020-03-26 20:00:00,16,null,18128,18128,18128,42,5,0,5248,560,5808
20200417,PA,29441,117932,null,2020-04-17 20:00:00,756,null,147373,147373,147373,42,49,0,4197,1706,5903
20200501,PA,46971,180477,null,2020-05-01 20:00:00,2354,null,227448,227448,227448,42,62,0,4875,1208,6083
20200406,PA,12980,70874,null,2020-04-06 20:00:00,162,1145,83854,83854,83854,42,12,73,4613,1470,6083
20200507,PA,52915,209873,null,2020-05-07 20:00:00,3416,null,262788,262788,262788,42,310,0,5378,1070,6448
20200430,PA,45763,175602,null,2020-04-30 20:00:00,2292,null,221365,221365,221365,42,97,0,5085,1397,6482
20200402,PA,7016,47698,null,2020-04-02 20:00:00,90,730,54714,54714,54714,42,16,110,5271,1211,6482
20200509,PA,55316,221791,null,2020-05-09 20:00:00,3688,null,277107,277107,277107,42,72,0,5470,1078,6548
20200418,PA,31069,122896,null,2020-04-18 20:00:00,836,null,153965,153965,153965,42,80,0,4964,1628,6592
20200425,PA,40049,152886,null,2020-04-25 20:00:00,1537,null,192935,192935,192935,42,45,0,5395,1397,6792
20200424,PA,38652,147491,null,2020-04-24 20:00:00,1492,null,186143,186143,186143,42,71,0,5430,1599,7029
20200409,PA,18228,87374,null,2020-04-09 20:00:00,338,null,105602,105602,105602,42,29,0,5075,1989,7064
20200411,PA,21655,98498,null,2020-04-11 20:00:00,494,null,120153,120153,120153,42,78,0,5458,1676,7134
20200423,PA,37053,142061,null,2020-04-23 20:00:00,1421,null,179114,179114,179114,42,-201,0,5789,1369,7158
20200408,PA,16239,82299,null,2020-04-08 20:00:00,309,null,98538,98538,98538,42,69,0,5580,1680,7260
20200510,PA,56611,227772,null,2020-05-10 20:00:00,3707,null,284383,284383,284383,42,19,0,5981,1295,7276
20200403,PA,8420,53695,null,2020-04-03 20:00:00,102,852,62115,62115,62115,42,12,122,5997,1404,7401
20200410,PA,19979,93040,null,2020-04-10 20:00:00,416,null,113019,113019,113019,42,78,0,5666,1751,7417
20200407,PA,14559,76719,null,2020-04-07 20:00:00,240,null,91278,91278,91278,42,78,0,5845,1579,7424
20200405,PA,11510,66261,null,2020-04-05 20:00:00,150,1072,77771,77771,77771,42,14,68,6248,1493,7741
20200508,PA,54238,216321,null,2020-05-08 20:00:00,3616,null,270559,270559,270559,42,200,0,6448,1323,7771
20200404,PA,10017,60013,null,2020-04-04 20:00:00,136,1004,70030,70030,70030,42,34,152,6318,1597,7915
20200502,PA,48305,187071,null,2020-05-02 20:00:00,2418,null,235376,235376,235376,42,64,0,6594,1334,7928
20200306,PA,2,null,null,2020-03-06 21:00:00,null,null,2,2,2,42,null,null,null,null,null
20200506,PR,1968,null,null,2020-05-06 20:00:00,99,null,1968,1968,1968,72,0,0,0,44,-9269
20200422,PR,915,8842,1954,2020-04-22 20:00:00,67,null,11711,9757,9757,72,3,0,53,-383,-330
20200317,PR,5,13,4,2020-03-17 20:00:00,null,null,22,18,18,72,0,0,4,0,4
20200428,PR,1400,9313,1940,2020-04-28 20:00:00,86,null,12653,10713,10713,72,2,0,0,11,11
20200323,PR,31,189,35,2020-03-23 20:00:00,2,null,255,220,220,72,1,0,6,8,14
20200509,PR,2173,null,null,2020-05-09 20:00:00,108,null,2173,2173,2173,72,1,0,0,17,17
20200427,PR,1389,9313,1940,2020-04-27 20:00:00,84,null,12642,10702,10702,72,0,0,0,18,18
20200318,PR,5,31,21,2020-03-18 20:00:00,null,null,57,36,36,72,0,0,18,0,18
20200510,PR,2198,null,null,2020-05-10 20:00:00,111,null,2198,2198,2198,72,3,0,0,25,25
20200319,PR,5,56,29,2020-03-19 20:00:00,null,null,90,61,61,72,0,0,25,0,25
20200425,PR,1307,9313,1940,2020-04-25 20:00:00,83,null,12560,10620,10620,72,6,0,0,31,31
20200429,PR,1433,9313,1940,2020-04-29 20:00:00,86,null,12686,10746,10746,72,0,0,0,33,33
20200504,PR,1843,9313,null,2020-05-04 20:00:00,97,null,11156,11156,11156,72,0,0,0,35,35
20200501,PR,1575,9313,null,2020-05-01 20:00:00,92,null,10888,10888,10888,72,0,0,0,36,36
20200321,PR,21,143,71,2020-03-21 20:00:00,null,null,235,164,164,72,0,0,29,7,36
20200322,PR,23,183,69,2020-03-22 20:00:00,1,null,275,206,206,72,1,0,40,2,42
20200503,PR,1808,9313,null,2020-05-03 20:00:00,97,null,11121,11121,11121,72,2,0,0,51,51
20200511,PR,2256,null,null,2020-05-11 20:00:00,113,null,2256,2256,2256,72,2,0,0,58,58
20200325,PR,51,317,70,2020-03-25 20:00:00,2,null,438,368,368,72,0,0,49,12,61
20200507,PR,2031,null,null,2020-05-07 20:00:00,102,null,2031,2031,2031,72,3,0,0,63,63
20200426,PR,1371,9313,1940,2020-04-26 20:00:00,84,null,12624,10684,10684,72,1,0,0,64,64
20200320,PR,14,114,52,2020-03-20 20:00:00,null,null,180,128,128,72,0,0,58,9,67
20200326,PR,64,377,335,2020-03-26 20:00:00,2,null,776,441,441,72,0,0,60,13,73
20200505,PR,1924,9313,null,2020-05-05 20:00:00,99,null,11237,11237,11237,72,2,0,0,81,81
20200324,PR,39,268,42,2020-03-24 20:00:00,2,null,349,307,307,72,0,0,79,8,87
20200430,PR,1539,9313,null,2020-04-30 20:00:00,92,null,10852,10852,10852,72,6,0,0,106,106
20200508,PR,2156,null,null,2020-05-08 20:00:00,107,null,2156,2156,2156,72,5,0,0,125,125
20200329,PR,127,841,817,2020-03-29 20:00:00,5,null,1785,968,968,72,2,0,102,27,129
20200330,PR,174,931,794,2020-03-30 20:00:00,6,null,1899,1105,1105,72,1,0,90,47,137
20200413,PR,903,5960,1288,2020-04-13 20:00:00,45,null,8151,6863,6863,72,1,0,141,6,147
20200327,PR,79,519,334,2020-03-27 20:00:00,3,null,932,598,598,72,1,0,142,15,157
20200502,PR,1757,9313,null,2020-05-02 20:00:00,95,null,11070,11070,11070,72,3,0,0,182,182
20200402,PR,316,1604,1119,2020-04-02 20:00:00,12,null,3039,1920,1920,72,1,0,195,30,225
20200418,PR,1118,8055,1760,2020-04-18 20:00:00,60,null,10933,9173,9173,72,2,0,191,50,241
20200328,PR,100,739,792,2020-03-28 20:00:00,3,null,1631,839,839,72,0,0,220,21,241
20200420,PR,1252,8486,1895,2020-04-20 20:00:00,63,null,11633,9738,9738,72,1,0,206,39,245
20200401,PR,286,1409,897,2020-04-01 20:00:00,11,null,2592,1695,1695,72,3,0,214,47,261
20200419,PR,1213,8280,1839,2020-04-19 20:00:00,62,null,11332,9493,9493,72,2,0,225,95,320
20200331,PR,239,1195,854,2020-03-31 20:00:00,8,null,2288,1434,1434,72,2,0,264,65,329
20200414,PR,923,6284,1322,2020-04-14 20:00:00,45,null,8529,7207,7207,72,0,0,324,20,344
20200412,PR,897,5819,1251,2020-04-12 20:00:00,44,null,7967,6716,6716,72,2,0,236,109,345
20200408,PR,620,4266,1160,2020-04-08 20:00:00,24,null,6046,4886,4886,72,1,0,300,47,347
20200421,PR,1298,8789,1761,2020-04-21 20:00:00,64,null,11848,10087,10087,72,1,0,303,46,349
20200424,PR,1276,9313,1940,2020-04-24 20:00:00,77,null,12529,10589,10589,72,8,0,0,361,361
20200406,PR,513,3432,1000,2020-04-06 20:00:00,21,null,4945,3945,3945,72,1,0,359,38,397
20200410,PR,725,5121,1392,2020-04-10 20:00:00,39,null,7238,5846,5846,72,6,0,418,42,460
20200423,PR,915,9313,1951,2020-04-23 20:00:00,69,null,12179,10228,10228,72,2,0,471,0,471
20200405,PR,475,3073,1039,2020-04-05 20:00:00,20,null,4587,3548,3548,72,2,0,468,23,491
20200409,PR,683,4703,1304,2020-04-09 20:00:00,33,null,6690,5386,5386,72,9,0,437,63,500
20200403,PR,378,2049,1055,2020-04-03 20:00:00,15,null,3482,2427,2427,72,3,0,445,62,507
20200411,PR,788,5583,1332,2020-04-11 20:00:00,42,null,7703,6371,6371,72,3,0,462,63,525
20200416,PR,1043,7315,1465,2020-04-16 20:00:00,56,null,9823,8358,8358,72,5,0,490,69,559
20200417,PR,1068,7864,1478,2020-04-17 20:00:00,58,null,10410,8932,8932,72,2,0,549,25,574
20200415,PR,974,6825,1410,2020-04-15 20:00:00,51,null,9209,7799,7799,72,6,0,541,51,592
20200407,PR,573,3966,968,2020-04-07 20:00:00,23,null,5507,4539,4539,72,2,0,534,60,594
20200404,PR,452,2605,1129,2020-04-04 20:00:00,18,null,4186,3057,3057,72,3,0,556,74,630
20200316,PR,5,9,null,2020-03-16 20:00:00,null,null,14,14,14,72,null,null,null,null,null
20200312,RI,5,94,8,2020-03-12 20:00:00,null,null,107,99,99,44,0,0,0,0,0
20200309,RI,3,30,6,2020-03-09 20:00:00,null,null,39,33,33,44,0,0,0,0,0
20200302,RI,1,null,null,2020-03-02 21:00:00,null,null,1,1,1,44,0,0,0,0,0
20200308,RI,3,30,12,2020-03-08 20:00:00,null,null,45,33,33,44,0,0,0,1,1
20200306,RI,3,17,null,2020-03-06 21:00:00,null,null,20,20,20,44,0,0,0,1,1
20200304,RI,2,11,null,2020-03-04 21:00:00,null,null,13,13,13,44,0,0,5,0,5
20200305,RI,2,17,null,2020-03-05 21:00:00,null,null,19,19,19,44,0,0,6,0,6
20200303,RI,2,6,null,2020-03-03 21:00:00,null,null,8,8,8,44,0,0,6,1,7
20200307,RI,2,30,null,2020-03-07 21:00:00,null,null,32,32,32,44,0,0,13,-1,12
20200310,RI,3,58,6,2020-03-10 20:00:00,null,null,67,61,61,44,0,0,28,0,28
20200326,RI,165,1262,181,2020-03-26 20:00:00,null,null,1608,1427,1427,44,0,0,0,33,33
20200316,RI,21,308,149,2020-03-16 20:00:00,null,null,478,329,329,44,0,0,37,1,38
20200311,RI,5,94,24,2020-03-11 20:00:00,null,null,123,99,99,44,0,0,36,2,38
20200313,RI,14,142,29,2020-03-13 20:00:00,null,null,185,156,156,44,0,0,48,9,57
20200314,RI,20,198,57,2020-03-14 20:00:00,null,null,275,218,218,44,0,0,56,6,62
20200325,RI,132,1262,196,2020-03-25 20:00:00,null,null,1590,1394,1394,44,0,0,62,8,70
20200315,RI,20,271,57,2020-03-15 20:00:00,null,null,348,291,291,44,0,0,73,0,73
20200321,RI,66,862,290,2020-03-21 20:00:00,null,null,1218,928,928,44,0,0,62,12,74
20200324,RI,124,1200,77,2020-03-24 20:00:00,null,null,1401,1324,1324,44,0,0,57,18,75
20200322,RI,83,932,216,2020-03-22 20:00:00,null,null,1231,1015,1015,44,0,0,70,17,87
20200317,RI,23,403,149,2020-03-17 20:00:00,null,null,575,426,426,44,0,0,95,2,97
20200319,RI,44,654,334,2020-03-19 20:00:00,null,null,1032,698,698,44,0,0,114,11,125
20200318,RI,33,540,334,2020-03-18 20:00:00,null,null,907,573,573,44,0,0,137,10,147
20200320,RI,54,800,140,2020-03-20 20:00:00,null,null,994,854,854,44,0,0,146,10,156
20200323,RI,106,1143,216,2020-03-23 20:00:00,null,null,1465,1249,1249,44,0,0,211,23,234
20200328,RI,239,2541,138,2020-03-28 20:00:00,null,null,2918,2780,2780,44,0,0,235,36,271
20200409,RI,1727,10682,null,2020-04-09 20:00:00,43,null,12409,12409,12409,44,8,0,0,277,277
20200413,RI,2976,17685,null,2020-04-13 20:00:00,73,331,20661,20661,20661,44,10,331,0,311,311
20200329,RI,294,2840,null,2020-03-29 20:00:00,3,null,3134,3134,3134,44,3,0,299,55,354
20200331,RI,489,3476,null,2020-03-31 20:00:00,8,null,3965,3965,3965,44,4,0,289,87,376
20200401,RI,566,3831,null,2020-04-01 20:00:00,10,null,4397,4397,4397,44,2,0,355,77,432
20200330,RI,402,3187,null,2020-03-30 20:00:00,4,null,3589,3589,3589,44,1,0,347,108,455
20200403,RI,709,4857,null,2020-04-03 20:00:00,14,null,5566,5566,5566,44,2,0,445,52,497
20200402,RI,657,4412,null,2020-04-02 20:00:00,12,null,5069,5069,5069,44,2,0,581,91,672
20200405,RI,922,6259,null,2020-04-05 20:00:00,25,null,7181,7181,7181,44,8,0,675,116,791
20200404,RI,806,5584,null,2020-04-04 20:00:00,17,null,6390,6390,6390,44,3,0,727,97,824
20200327,RI,203,2306,138,2020-03-27 20:00:00,null,null,2647,2509,2509,44,0,0,1044,38,1082
20200406,RI,1082,7399,null,2020-04-06 20:00:00,27,null,8481,8481,8481,44,2,0,1140,160,1300
20200428,RI,7926,49767,null,2020-04-28 20:00:00,239,732,57693,57693,57693,44,6,14,1590,218,1808
20200408,RI,1450,10682,null,2020-04-08 20:00:00,35,null,12132,12132,12132,44,5,0,1605,220,1825
20200407,RI,1230,9077,null,2020-04-07 20:00:00,30,null,10307,10307,10307,44,3,0,1678,148,1826
20200410,RI,2015,12281,null,2020-04-10 20:00:00,49,null,14296,14296,14296,44,6,0,1599,288,1887
20200419,RI,4755,29993,null,2020-04-19 20:00:00,164,605,34748,34748,34748,44,14,27,1658,276,1934
20200503,RI,9477,62450,null,2020-05-03 20:00:00,320,1013,71927,71927,71927,44,24,36,1811,188,1999
20200418,RI,4479,28335,null,2020-04-18 20:00:00,150,578,32814,32814,32814,44,32,247,1751,302,2053
20200511,RI,11450,81882,null,2020-05-11 20:00:00,430,1280,93332,93332,93332,44,8,29,1943,176,2119
20200412,RI,2665,17685,null,2020-04-12 20:00:00,63,null,20350,20350,20350,44,7,0,1827,316,2143
20200416,RI,3838,24226,null,2020-04-16 20:00:00,105,331,28064,28064,28064,44,18,0,1858,309,2167
20200504,RI,9652,64484,null,2020-05-04 20:00:00,341,1061,74136,74136,74136,44,21,48,2034,175,2209
20200421,RI,5467,33833,null,2020-04-21 20:00:00,186,674,39300,39300,39300,44,11,45,1843,369,2212
20200414,RI,3251,19649,null,2020-04-14 20:00:00,80,331,22900,22900,22900,44,7,0,1964,275,2239
20200505,RI,9933,66502,null,2020-05-05 20:00:00,355,1092,76435,76435,76435,44,14,31,2018,281,2299
20200420,RI,5098,31990,null,2020-04-20 20:00:00,175,629,37088,37088,37088,44,11,24,1997,343,2340
20200422,RI,5845,35881,null,2020-04-22 20:00:00,201,717,41726,41726,41726,44,15,43,2048,378,2426
20200429,RI,8247,51918,null,2020-04-29 20:00:00,251,750,60165,60165,60165,44,12,18,2151,321,2472
20200427,RI,7708,48177,null,2020-04-27 20:00:00,233,718,55885,55885,55885,44,7,27,2213,269,2482
20200426,RI,7439,45964,null,2020-04-26 20:00:00,226,691,53403,53403,53403,44,11,115,2202,310,2512
20200509,RI,10989,76826,null,2020-05-09 20:00:00,418,1218,87815,87815,87815,44,19,31,2339,210,2549
20200417,RI,4177,26584,null,2020-04-17 20:00:00,118,331,30761,30761,30761,44,13,0,2358,339,2697
20200423,RI,6262,38163,null,2020-04-23 20:00:00,213,757,44425,44425,44425,44,12,40,2282,417,2699
20200424,RI,6699,40558,null,2020-04-24 20:00:00,202,576,47257,47257,47257,44,-11,-181,2395,437,2832
20200506,RI,10205,69168,null,2020-05-06 20:00:00,370,1123,79373,79373,79373,44,15,31,2666,272,2938
20200501,RI,8962,57686,null,2020-05-01 20:00:00,279,937,66648,66648,66648,44,13,41,2597,341,2938
20200507,RI,10530,71788,null,2020-05-07 20:00:00,388,1153,82318,82318,82318,44,18,30,2620,325,2945
20200508,RI,10779,74487,null,2020-05-08 20:00:00,399,1187,85266,85266,85266,44,11,34,2699,249,2948
20200415,RI,3529,22368,null,2020-04-15 20:00:00,87,331,25897,25897,25897,44,7,0,2719,278,2997
20200502,RI,9289,60639,null,2020-05-02 20:00:00,296,977,69928,69928,69928,44,17,40,2953,327,3280
20200510,RI,11274,79939,null,2020-05-10 20:00:00,422,1251,91213,91213,91213,44,4,33,3113,285,3398
20200430,RI,8621,55089,null,2020-04-30 20:00:00,266,896,63710,63710,63710,44,15,146,3171,374,3545
20200425,RI,7129,43762,null,2020-04-25 20:00:00,215,576,50891,50891,50891,44,13,0,3204,430,3634
20200411,RI,2349,15858,null,2020-04-11 20:00:00,56,null,18207,18207,18207,44,7,0,3577,334,3911
20200301,RI,1,null,null,2020-03-01 21:00:00,null,null,1,1,1,44,null,null,null,null,null
20200508,SC,7142,66300,null,2020-05-08 20:00:00,316,1152,73442,73442,73442,45,11,0,-4246,206,-4040
20200511,SC,7653,76804,null,2020-05-11 20:00:00,331,1252,84457,84457,84457,45,0,0,0,0,0
20200507,SC,6936,70546,null,2020-05-07 20:00:00,305,1152,77482,77482,77482,45,0,0,0,0,0
20200504,SC,6626,57562,null,2020-05-04 20:00:00,275,1110,64188,64188,64188,45,0,0,0,0,0
20200427,SC,5490,45271,null,2020-04-27 20:00:00,174,944,50761,50761,50761,45,0,0,0,0,0
20200424,SC,4917,39546,null,2020-04-24 20:00:00,150,837,44463,44463,44463,45,0,0,0,0,0
20200420,SC,4377,36103,null,2020-04-20 20:00:00,120,776,40480,40480,40480,45,0,0,0,0,0
20200416,SC,3656,31077,null,2020-04-16 20:00:00,107,675,34733,34733,34733,45,0,0,0,0,0
20200413,SC,3319,28106,null,2020-04-13 20:00:00,82,496,31425,31425,31425,45,0,0,0,0,0
20200406,SC,2049,16927,null,2020-04-06 20:00:00,44,241,18976,18976,18976,45,0,0,0,0,0
20200403,SC,1554,5441,null,2020-04-03 20:00:00,31,241,6995,6995,6995,45,0,0,0,0,0
20200327,SC,456,2307,null,2020-03-27 20:00:00,9,102,2763,2763,2763,45,0,0,0,0,0
20200319,SC,60,583,null,2020-03-19 20:00:00,1,null,643,643,643,45,0,0,0,0,0
20200310,SC,7,24,null,2020-03-10 20:00:00,null,null,31,31,31,45,0,0,0,0,0
20200308,SC,2,8,null,2020-03-08 20:00:00,null,null,10,10,10,45,0,0,0,0,0
20200306,SC,0,5,null,2020-03-06 21:00:00,null,null,5,5,5,45,0,0,0,0,0
20200305,SC,0,5,null,2020-03-05 21:00:00,null,null,5,5,5,45,0,0,0,0,0
20200307,SC,2,8,null,2020-03-07 21:00:00,null,null,10,10,10,45,0,0,3,2,5
20200311,SC,9,32,null,2020-03-11 20:00:00,null,null,41,41,41,45,0,0,8,2,10
20200312,SC,10,48,null,2020-03-12 20:00:00,null,null,58,58,58,45,0,0,16,1,17
20200309,SC,7,24,null,2020-03-09 20:00:00,null,null,31,31,31,45,0,0,16,5,21
20200313,SC,12,75,null,2020-03-13 20:00:00,null,null,87,87,87,45,0,0,27,2,29
20200326,SC,456,2307,null,2020-03-26 20:00:00,9,102,2763,2763,2763,45,2,0,4,32,36
20200314,SC,13,110,null,2020-03-14 20:00:00,null,null,123,123,123,45,0,0,35,1,36
20200315,SC,19,154,null,2020-03-15 20:00:00,null,null,173,173,173,45,0,0,44,6,50
20200317,SC,33,311,null,2020-03-17 20:00:00,1,null,344,344,344,45,0,0,76,5,81
20200316,SC,28,235,null,2020-03-16 20:00:00,1,null,263,263,263,45,1,0,81,9,90
20200323,SC,298,1466,null,2020-03-23 20:00:00,5,null,1764,1764,1764,45,2,0,0,103,103
20200328,SC,539,2408,null,2020-03-28 20:00:00,13,102,2947,2947,2947,45,4,0,101,83,184
20200322,SC,195,1466,null,2020-03-22 20:00:00,3,null,1661,1661,1661,45,2,0,211,43,254
20200320,SC,81,833,null,2020-03-20 20:00:00,1,null,914,914,914,45,0,0,250,21,271
20200318,SC,60,583,null,2020-03-18 20:00:00,1,null,643,643,643,45,0,0,272,27,299
20200325,SC,424,2303,null,2020-03-25 20:00:00,7,102,2727,2727,2727,45,2,102,291,126,417
20200321,SC,152,1255,null,2020-03-21 20:00:00,1,null,1407,1407,1407,45,0,0,422,71,493
20200324,SC,298,2012,null,2020-03-24 20:00:00,5,null,2310,2310,2310,45,0,0,546,0,546
20200331,SC,1083,4616,null,2020-03-31 20:00:00,22,102,5699,5699,5699,45,4,0,456,158,614
20200401,SC,1293,5033,null,2020-04-01 20:00:00,26,102,6326,6326,6326,45,4,0,417,210,627
20200405,SC,2049,16927,null,2020-04-05 20:00:00,44,241,18976,18976,18976,45,4,0,530,132,662
20200402,SC,1554,5441,null,2020-04-02 20:00:00,31,241,6995,6995,6995,45,5,139,408,261,669
20200421,SC,4439,36838,null,2020-04-21 20:00:00,124,776,41277,41277,41277,45,4,0,735,62,797
20200410,SC,3065,25118,null,2020-04-10 20:00:00,72,496,28183,28183,28183,45,5,255,543,273,816
20200329,SC,774,3015,null,2020-03-29 20:00:00,16,102,3789,3789,3789,45,3,0,607,235,842
20200415,SC,3656,31077,null,2020-04-15 20:00:00,107,675,34733,34733,34733,45,10,0,758,103,861
20200408,SC,2552,22082,null,2020-04-08 20:00:00,63,241,24634,24634,24634,45,12,0,819,135,954
20200330,SC,925,4160,null,2020-03-30 20:00:00,18,102,5085,5085,5085,45,2,0,1145,151,1296
20200412,SC,3319,28106,null,2020-04-12 20:00:00,82,496,31425,31425,31425,45,2,0,1220,112,1332
20200423,SC,4917,39546,null,2020-04-23 20:00:00,150,837,44463,44463,44463,45,10,0,1196,156,1352
20200428,SC,5613,46532,null,2020-04-28 20:00:00,177,944,52145,52145,52145,45,3,0,1261,123,1384
20200417,SC,3931,32353,null,2020-04-17 20:00:00,109,675,36284,36284,36284,45,2,0,1276,275,1551
20200419,SC,4377,36103,null,2020-04-19 20:00:00,120,776,40480,40480,40480,45,1,0,1516,131,1647
20200426,SC,5490,45271,null,2020-04-26 20:00:00,174,944,50761,50761,50761,45,8,0,1510,237,1747
20200422,SC,4761,38350,null,2020-04-22 20:00:00,140,837,43111,43111,43111,45,16,61,1512,322,1834
20200411,SC,3207,26886,null,2020-04-11 20:00:00,80,496,30093,30093,30093,45,8,0,1768,142,1910
20200429,SC,5881,48336,null,2020-04-29 20:00:00,203,1000,54217,54217,54217,45,26,56,1804,268,2072
20200502,SC,6489,55127,null,2020-05-02 20:00:00,267,1110,61616,61616,61616,45,11,0,2006,231,2237
20200430,SC,6095,50417,null,2020-04-30 20:00:00,244,1000,56512,56512,56512,45,41,0,2081,214,2295
20200414,SC,3553,30319,null,2020-04-14 20:00:00,97,675,33872,33872,33872,45,15,179,2213,234,2447
20200418,SC,4246,34587,null,2020-04-18 20:00:00,119,776,38833,38833,38833,45,10,101,2234,315,2549
20200503,SC,6626,57562,null,2020-05-03 20:00:00,275,1110,64188,64188,64188,45,8,0,2435,137,2572
20200409,SC,2792,24575,null,2020-04-09 20:00:00,67,241,27367,27367,27367,45,4,0,2493,240,2733
20200501,SC,6258,53121,null,2020-05-01 20:00:00,256,1110,59379,59379,59379,45,12,110,2704,163,2867
20200510,SC,7653,76804,null,2020-05-10 20:00:00,331,1252,84457,84457,84457,45,1,0,3372,122,3494
20200505,SC,6757,61014,null,2020-05-05 20:00:00,283,1110,67771,67771,67771,45,8,0,3452,131,3583
20200425,SC,5253,43761,null,2020-04-25 20:00:00,166,944,49014,49014,49014,45,16,107,4215,336,4551
20200407,SC,2417,21263,null,2020-04-07 20:00:00,51,241,23680,23680,23680,45,7,0,4336,368,4704
20200509,SC,7531,73432,null,2020-05-09 20:00:00,330,1252,80963,80963,80963,45,14,100,7132,389,7521
20200506,SC,6936,70546,null,2020-05-06 20:00:00,305,1152,77482,77482,77482,45,22,42,9532,179,9711
20200404,SC,1917,16397,null,2020-04-04 20:00:00,40,241,18314,18314,18314,45,9,0,10956,363,11319
20200304,SC,0,5,null,2020-03-04 21:00:00,null,null,5,5,5,45,null,null,null,null,null
20200319,SD,11,551,385,2020-03-19 20:00:00,1,null,947,562,562,46,0,0,0,0,0
20200318,SD,11,551,350,2020-03-18 20:00:00,1,null,912,562,562,46,1,0,0,0,0
20200309,SD,0,5,0,2020-03-09 20:00:00,null,null,5,5,5,46,0,0,0,0,0
20200308,SD,0,5,0,2020-03-08 20:00:00,null,null,5,5,5,46,0,0,0,0,0
20200310,SD,0,11,0,2020-03-10 20:00:00,null,null,11,11,11,46,0,0,6,0,6
20200311,SD,5,13,2,2020-03-11 20:00:00,null,null,20,18,18,46,0,0,2,5,7
20200312,SD,8,27,11,2020-03-12 20:00:00,null,null,46,35,35,46,0,0,14,3,17
20200321,SD,14,691,268,2020-03-21 20:00:00,1,null,973,705,705,46,0,0,28,0,28
20200323,SD,28,762,265,2020-03-23 20:00:00,1,null,1055,790,790,46,0,0,22,7,29
20200324,SD,30,790,268,2020-03-24 20:00:00,1,null,1088,820,820,46,0,0,28,2,30
20200325,SD,41,819,268,2020-03-25 20:00:00,1,null,1128,860,860,46,0,0,29,11,40
20200313,SD,9,73,11,2020-03-13 20:00:00,null,null,93,82,82,46,0,0,46,1,47
20200322,SD,21,740,277,2020-03-22 20:00:00,1,null,1038,761,761,46,0,0,49,7,56
20200317,SD,11,551,35,2020-03-17 20:00:00,null,null,597,562,562,46,0,0,57,1,58
20200427,SD,2245,14130,null,2020-04-27 20:00:00,11,150,16375,16375,16375,46,0,15,68,33,101
20200314,SD,9,182,3,2020-03-14 20:00:00,null,null,194,191,191,46,0,0,109,0,109
20200320,SD,14,663,270,2020-03-20 20:00:00,1,null,947,677,677,46,0,0,112,3,115
20200331,SD,108,3609,0,2020-03-31 20:00:00,1,12,3717,3717,3717,46,0,12,131,7,138
20200315,SD,9,327,6,2020-03-15 20:00:00,null,null,342,336,336,46,0,0,145,0,145
20200316,SD,10,494,0,2020-03-16 20:00:00,null,null,504,504,504,46,0,0,167,1,168
20200430,SD,2449,14579,null,2020-04-30 20:00:00,17,173,17028,17028,17028,46,4,8,119,76,195
20200328,SD,68,2592,0,2020-03-28 20:00:00,1,null,2660,2660,2660,46,0,0,205,10,215
20200429,SD,2373,14460,null,2020-04-29 20:00:00,13,165,16833,16833,16833,46,2,8,161,60,221
20200428,SD,2313,14299,null,2020-04-28 20:00:00,11,157,16612,16612,16612,46,0,7,169,68,237
20200407,SD,320,5948,2,2020-04-07 20:00:00,6,23,6270,6268,6268,46,2,0,216,32,248
20200420,SD,1685,10641,0,2020-04-20 20:00:00,7,87,12326,12326,12326,46,0,13,214,50,264
20200414,SD,988,8308,0,2020-04-14 20:00:00,6,45,9296,9296,9296,46,0,1,174,120,294
20200504,SD,2668,16045,null,2020-05-04 20:00:00,21,211,18713,18713,18713,46,0,14,259,37,296
20200505,SD,2721,16301,null,2020-05-05 20:00:00,24,220,19022,19022,19022,46,3,9,256,53,309
20200401,SD,129,3903,0,2020-04-01 20:00:00,2,12,4032,4032,4032,46,1,0,294,21,315
20200503,SD,2631,15786,null,2020-05-03 20:00:00,21,197,18417,18417,18417,46,0,10,283,43,326
20200501,SD,2525,14838,null,2020-05-01 20:00:00,21,179,17363,17363,17363,46,4,6,259,76,335
20200402,SD,165,4217,0,2020-04-02 20:00:00,2,17,4382,4382,4382,46,0,5,314,36,350
20200411,SD,626,7378,2,2020-04-11 20:00:00,6,33,8006,8004,8004,46,0,4,267,90,357
20200330,SD,101,3478,0,2020-03-30 20:00:00,1,null,3579,3579,3579,46,0,0,351,11,362
20200405,SD,240,5353,null,2020-04-05 20:00:00,2,22,5593,5593,5593,46,0,3,341,28,369
20200506,SD,2779,16637,null,2020-05-06 20:00:00,29,230,19416,19416,19416,46,5,10,336,58,394
20200403,SD,187,4593,3,2020-04-03 20:00:00,2,17,4783,4780,4780,46,0,0,376,22,398
20200409,SD,447,6700,null,2020-04-09 20:00:00,6,27,7147,7147,7147,46,0,1,345,54,399
20200419,SD,1635,10427,0,2020-04-19 20:00:00,7,74,12062,12062,12062,46,0,6,309,93,402
20200327,SD,58,2387,20,2020-03-27 20:00:00,1,null,2465,2445,2445,46,0,0,414,12,426
20200406,SD,288,5732,0,2020-04-06 20:00:00,4,23,6020,6020,6020,46,2,1,379,48,427
20200404,SD,212,5012,1,2020-04-04 20:00:00,2,19,5225,5224,5224,46,0,2,419,25,444
20200413,SD,868,8134,0,2020-04-13 20:00:00,6,44,9002,9002,9002,46,0,1,311,138,449
20200408,SD,393,6355,0,2020-04-08 20:00:00,6,26,6748,6748,6748,46,0,3,407,73,480
20200421,SD,1755,11060,null,2020-04-21 20:00:00,8,100,12815,12815,12815,46,1,13,419,70,489
20200410,SD,536,7111,null,2020-04-10 20:00:00,6,29,7647,7647,7647,46,0,2,411,89,500
20200417,SD,1411,9651,0,2020-04-17 20:00:00,7,63,11062,11062,11062,46,0,8,412,100,512
20200412,SD,730,7823,0,2020-04-12 20:00:00,6,43,8553,8553,8553,46,0,10,445,104,549
20200329,SD,90,3127,1,2020-03-29 20:00:00,1,null,3218,3217,3217,46,0,0,535,22,557
20200415,SD,1168,8691,0,2020-04-15 20:00:00,6,51,9859,9859,9859,46,0,6,383,180,563
20200418,SD,1542,10118,1,2020-04-18 20:00:00,7,68,11661,11660,11660,46,0,5,467,131,598
20200423,SD,1956,12109,null,2020-04-23 20:00:00,9,119,14065,14065,14065,46,1,8,521,98,619
20200422,SD,1858,11588,null,2020-04-22 20:00:00,8,111,13446,13446,13446,46,0,11,528,103,631
20200426,SD,2212,14062,null,2020-04-26 20:00:00,11,135,16274,16274,16274,46,1,7,613,65,678
20200511,SD,3614,20964,null,2020-05-11 20:00:00,34,263,24578,24578,24578,46,0,2,587,97,684
20200416,SD,1311,9239,2,2020-04-16 20:00:00,7,55,10552,10550,10550,46,1,4,548,143,691
20200507,SD,2905,17209,null,2020-05-07 20:00:00,31,236,20114,20114,20114,46,2,6,572,126,698
20200502,SD,2588,15503,null,2020-05-02 20:00:00,21,187,18091,18091,18091,46,0,8,665,63,728
20200424,SD,2040,12784,null,2020-04-24 20:00:00,10,124,14824,14824,14824,46,1,5,675,84,759
20200425,SD,2147,13449,null,2020-04-25 20:00:00,10,128,15596,15596,15596,46,0,4,665,107,772
20200510,SD,3517,20377,null,2020-05-10 20:00:00,34,261,23894,23894,23894,46,0,8,818,124,942
20200326,SD,46,1973,125,2020-03-26 20:00:00,1,null,2144,2019,2019,46,0,0,1154,5,1159
20200508,SD,3144,18149,null,2020-05-08 20:00:00,31,247,21293,21293,21293,46,0,11,940,239,1179
20200509,SD,3393,19559,null,2020-05-09 20:00:00,34,253,22952,22952,22952,46,3,6,1410,249,1659
20200307,SD,0,5,0,2020-03-07 21:00:00,null,null,5,5,5,46,null,null,null,null,null
20200309,TN,3,null,null,2020-03-09 20:00:00,null,null,3,3,3,47,0,0,0,0,0
20200307,TN,1,null,null,2020-03-07 21:00:00,null,null,1,1,1,47,0,0,0,0,0
20200306,TN,1,null,null,2020-03-06 21:00:00,null,null,1,1,1,47,0,0,0,0,0
20200308,TN,3,null,null,2020-03-08 20:00:00,null,null,3,3,3,47,0,0,0,2,2
20200310,TN,7,null,null,2020-03-10 20:00:00,null,null,7,7,7,47,0,0,0,4,4
20200314,TN,32,130,null,2020-03-14 20:00:00,null,null,162,162,162,47,0,0,14,6,20
20200315,TN,39,157,null,2020-03-15 20:00:00,null,null,196,196,196,47,0,0,27,7,34
20200312,TN,18,79,null,2020-03-12 20:00:00,null,null,97,97,97,47,0,0,29,11,40
20200318,TN,98,349,null,2020-03-18 20:00:00,null,null,447,447,447,47,0,0,19,25,44
20200313,TN,26,116,null,2020-03-13 20:00:00,null,null,142,142,142,47,0,0,37,8,45
20200311,TN,7,50,null,2020-03-11 20:00:00,null,null,57,57,57,47,0,0,50,0,50
20200319,TN,154,349,null,2020-03-19 20:00:00,null,null,503,503,503,47,0,0,0,56,56
20200317,TN,73,330,null,2020-03-17 20:00:00,null,null,403,403,403,47,0,0,60,21,81
20200323,TN,615,3272,null,2020-03-23 20:00:00,2,null,3887,3887,3887,47,2,0,0,110,110
20200316,TN,52,270,null,2020-03-16 20:00:00,null,null,322,322,322,47,0,0,113,13,126
20200322,TN,505,3272,null,2020-03-22 20:00:00,null,null,3777,3777,3777,47,0,0,0,134,134
20200320,TN,228,563,null,2020-03-20 20:00:00,null,null,791,791,791,47,0,0,214,74,288
20200325,TN,784,11012,null,2020-03-25 20:00:00,3,53,11796,11796,11796,47,1,53,495,117,612
20200327,TN,1203,14888,null,2020-03-27 20:00:00,6,103,16091,16091,16091,47,3,27,936,246,1182
20200406,TN,3802,43548,null,2020-04-06 20:00:00,65,352,47350,47350,47350,47,21,24,1881,169,2050
20200415,TN,6079,74817,null,2020-04-15 20:00:00,135,663,80896,80896,80896,47,11,30,1809,256,2065
20200402,TN,2845,31766,null,2020-04-02 20:00:00,32,263,34611,34611,34611,47,8,63,1997,162,2159
20200417,TN,6589,80684,null,2020-04-17 20:00:00,142,711,87273,87273,87273,47,1,20,1897,327,2224
20200329,TN,1537,19037,null,2020-03-29 20:00:00,7,133,20574,20574,20574,47,1,15,2072,164,2236
20200328,TN,1373,16965,null,2020-03-28 20:00:00,6,118,18338,18338,18338,47,0,15,2077,170,2247
20200414,TN,5823,73008,null,2020-04-14 20:00:00,124,633,78831,78831,78831,47,15,54,2423,213,2636
20200330,TN,1834,21470,null,2020-03-30 20:00:00,13,148,23304,23304,23304,47,6,15,2433,297,2730
20200321,TN,371,3272,null,2020-03-21 20:00:00,null,null,3643,3643,3643,47,0,0,2709,143,2852
20200410,TN,4862,57937,null,2020-04-10 20:00:00,98,536,62799,62799,62799,47,4,31,2722,228,2950
20200326,TN,957,13952,null,2020-03-26 20:00:00,3,76,14909,14909,14909,47,0,23,2940,173,3113
20200403,TN,3067,34772,null,2020-04-03 20:00:00,37,293,37839,37839,37839,47,5,30,3006,222,3228
20200409,TN,4634,55215,null,2020-04-09 20:00:00,94,505,59849,59849,59849,47,15,56,2959,272,3231
20200418,TN,6762,83824,null,2020-04-18 20:00:00,145,719,90586,90586,90586,47,3,8,3140,173,3313
20200404,TN,3321,38070,null,2020-04-04 20:00:00,43,311,41391,41391,41391,47,6,18,3298,254,3552
20200420,TN,7238,93451,null,2020-04-20 20:00:00,152,730,100689,100689,100689,47,4,6,3423,168,3591
20200408,TN,4362,52256,null,2020-04-08 20:00:00,79,449,56618,56618,56618,47,7,41,3520,224,3744
20200412,TN,5308,65369,null,2020-04-12 20:00:00,101,567,70677,70677,70677,47,0,11,3655,194,3849
20200405,TN,3633,41667,null,2020-04-05 20:00:00,44,328,45300,45300,45300,47,1,17,3597,312,3909
20200411,TN,5114,61714,null,2020-04-11 20:00:00,101,556,66828,66828,66828,47,3,20,3777,252,4029
20200331,TN,2239,25121,null,2020-03-31 20:00:00,23,175,27360,27360,27360,47,10,27,3651,405,4056
20200416,TN,6262,78787,null,2020-04-16 20:00:00,141,691,85049,85049,85049,47,6,28,3970,183,4153
20200401,TN,2683,29769,null,2020-04-01 20:00:00,24,200,32452,32452,32452,47,1,25,4648,444,5092
20200413,TN,5610,70585,null,2020-04-13 20:00:00,109,579,76195,76195,76195,47,8,12,5216,302,5518
20200407,TN,4138,48736,null,2020-04-07 20:00:00,72,408,52874,52874,52874,47,7,56,5188,336,5524
20200427,TN,9918,144484,null,2020-04-27 20:00:00,184,837,154402,154402,154402,47,3,9,5930,251,6181
20200419,TN,7070,90028,null,2020-04-19 20:00:00,148,724,97098,97098,97098,47,3,5,6204,308,6512
20200429,TN,10366,158183,null,2020-04-29 20:00:00,195,1013,168549,168549,168549,47,7,119,6307,314,6621
20200422,TN,7842,107138,null,2020-04-22 20:00:00,166,775,114980,114980,114980,47,9,15,6350,448,6798
20200426,TN,9667,138554,null,2020-04-26 20:00:00,181,828,148221,148221,148221,47,3,7,6337,478,6815
20200504,TN,13571,197872,null,2020-05-04 20:00:00,219,1143,211443,211443,211443,47,9,8,6442,394,6836
20200508,TN,14441,229137,null,2020-05-08 20:00:00,241,1299,243578,243578,243578,47,4,33,6905,345,7250
20200324,TN,667,10517,null,2020-03-24 20:00:00,2,null,11184,11184,11184,47,0,0,7245,52,7297
20200505,TN,13690,205172,null,2020-05-05 20:00:00,226,1156,218862,218862,218862,47,7,13,7300,119,7419
20200421,TN,7394,100788,null,2020-04-21 20:00:00,157,760,108182,108182,108182,47,5,30,7337,156,7493
20200428,TN,10052,151876,null,2020-04-28 20:00:00,188,894,161928,161928,161928,47,4,57,7392,134,7526
20200423,TN,8266,114834,null,2020-04-23 20:00:00,170,793,123100,123100,123100,47,4,18,7696,424,8120
20200424,TN,8726,122602,null,2020-04-24 20:00:00,168,808,131328,131328,131328,47,-2,15,7768,460,8228
20200506,TN,13938,213163,null,2020-05-06 20:00:00,239,1221,227101,227101,227101,47,13,65,7991,248,8239
20200503,TN,13177,191430,null,2020-05-03 20:00:00,210,1135,204607,204607,204607,47,1,10,7815,516,8331
20200501,TN,11891,174241,null,2020-05-01 20:00:00,204,1113,186132,186132,186132,47,5,68,7350,1156,8506
20200430,TN,10735,166891,null,2020-04-30 20:00:00,199,1045,177626,177626,177626,47,4,32,8708,369,9077
20200510,TN,14985,246884,null,2020-05-10 20:00:00,243,1325,261869,261869,261869,47,1,6,8904,217,9121
20200509,TN,14768,237980,null,2020-05-09 20:00:00,242,1319,252748,252748,252748,47,1,20,8843,327,9170
20200507,TN,14096,222232,null,2020-05-07 20:00:00,237,1266,236328,236328,236328,47,-2,45,9069,158,9227
20200425,TN,9189,132217,null,2020-04-25 20:00:00,178,821,141406,141406,141406,47,10,13,9615,463,10078
20200502,TN,12661,183615,null,2020-05-02 20:00:00,209,1125,196276,196276,196276,47,5,12,9374,770,10144
20200511,TN,15544,257733,null,2020-05-11 20:00:00,251,1344,273277,273277,273277,47,8,19,10849,559,11408
20200305,TN,1,null,null,2020-03-05 21:00:00,null,null,1,1,1,47,null,null,null,null,null
20200308,TX,8,null,null,2020-03-08 20:00:00,null,null,8,8,8,48,0,0,0,0,0
20200305,TX,1,null,null,2020-03-05 21:00:00,null,null,1,1,1,48,0,0,0,0,0
20200316,TX,57,null,null,2020-03-16 20:00:00,null,null,57,57,57,48,0,0,0,1,1
20200310,TX,13,null,null,2020-03-10 20:00:00,null,null,13,13,13,48,0,0,0,1,1
20200312,TX,23,null,null,2020-03-12 20:00:00,null,null,23,23,23,48,0,0,0,2,2
20200307,TX,8,null,null,2020-03-07 21:00:00,null,null,8,8,8,48,0,0,0,3,3
20200309,TX,12,null,null,2020-03-09 20:00:00,null,null,12,12,12,48,0,0,0,4,4
20200306,TX,5,null,null,2020-03-06 21:00:00,null,null,5,5,5,48,0,0,0,4,4
20200315,TX,56,null,null,2020-03-15 20:00:00,null,null,56,56,56,48,0,0,0,5,5
20200311,TX,21,null,null,2020-03-11 20:00:00,null,null,21,21,21,48,0,0,0,8,8
20200314,TX,51,null,null,2020-03-14 20:00:00,null,null,51,51,51,48,0,0,0,12,12
20200313,TX,39,null,null,2020-03-13 20:00:00,null,null,39,39,39,48,0,0,0,16,16
20200319,TX,143,2212,null,2020-03-19 20:00:00,3,null,2355,2355,2355,48,1,0,388,60,448
20200329,TX,2552,23208,null,2020-03-29 20:00:00,34,null,25760,25760,25760,48,7,0,0,500,500
20200318,TX,83,1824,null,2020-03-18 20:00:00,2,null,1907,1907,1907,48,1,0,620,19,639
20200324,TX,410,10757,null,2020-03-24 20:00:00,9,null,11167,11167,11167,48,1,0,1054,58,1112
20200317,TX,64,1204,null,2020-03-17 20:00:00,1,null,1268,1268,1268,48,1,0,1204,7,1211
20200321,TX,304,6218,null,2020-03-21 20:00:00,5,null,6522,6522,6522,48,0,0,1135,110,1245
20200323,TX,352,9703,null,2020-03-23 20:00:00,8,null,10055,10055,10055,48,3,0,1281,18,1299
20200328,TX,2052,23208,null,2020-03-28 20:00:00,27,null,25260,25260,25260,48,4,0,1273,321,1594
20200322,TX,334,8422,null,2020-03-22 20:00:00,5,null,8756,8756,8756,48,0,0,2204,30,2234
20200327,TX,1731,21935,null,2020-03-27 20:00:00,23,null,23666,23666,23666,48,5,0,1907,335,2242
20200325,TX,974,12520,null,2020-03-25 20:00:00,12,null,13494,13494,13494,48,3,0,1763,564,2327
20200402,TX,4669,46010,null,2020-04-02 20:00:00,70,null,50679,50679,50679,48,12,0,2150,672,2822
20200320,TX,194,5083,null,2020-03-20 20:00:00,5,null,5277,5277,5277,48,2,0,2871,51,2922
20200407,TX,8262,80387,null,2020-04-07 20:00:00,154,null,88649,88649,88649,48,14,0,2306,986,3292
20200412,TX,13484,111049,null,2020-04-12 20:00:00,271,null,124533,124533,124533,48,17,0,3077,923,4000
20200411,TX,12561,107972,null,2020-04-11 20:00:00,254,null,120533,120533,120533,48,28,0,3925,890,4815
20200401,TX,3997,43860,null,2020-04-01 20:00:00,58,null,47857,47857,47857,48,17,0,4134,731,4865
20200403,TX,5330,50434,null,2020-04-03 20:00:00,90,null,55764,55764,55764,48,20,0,4424,661,5085
20200415,TX,15492,136318,null,2020-04-15 20:00:00,364,null,151810,151810,151810,48,46,0,4475,868,5343
20200419,TX,18923,163787,null,2020-04-19 20:00:00,477,null,182710,182710,182710,48,24,0,5808,663,6471
20200418,TX,18260,157979,null,2020-04-18 20:00:00,453,null,176239,176239,176239,48,25,0,5814,889,6703
20200416,TX,16455,142092,null,2020-04-16 20:00:00,393,null,158547,158547,158547,48,29,0,5774,963,6737
20200331,TX,3266,39726,null,2020-03-31 20:00:00,41,null,42992,42992,42992,48,7,0,6723,389,7112
20200405,TX,6812,64126,null,2020-04-05 20:00:00,127,null,70938,70938,70938,48,22,0,6485,702,7187
20200408,TX,9353,86905,null,2020-04-08 20:00:00,177,null,96258,96258,96258,48,23,0,6518,1091,7609
20200420,TX,19458,170936,null,2020-04-20 20:00:00,495,null,190394,190394,190394,48,18,0,7149,535,7684
20200326,TX,1396,20028,null,2020-03-26 20:00:00,18,null,21424,21424,21424,48,6,0,7508,422,7930
20200404,TX,6110,57641,null,2020-04-04 20:00:00,105,null,63751,63751,63751,48,15,0,7207,780,7987
20200423,TX,21944,203134,null,2020-04-23 20:00:00,561,null,225078,225078,225078,48,18,0,7420,875,8295
20200413,TX,13906,119320,null,2020-04-13 20:00:00,287,null,133226,133226,133226,48,16,0,8271,422,8693
20200410,TX,11671,104047,null,2020-04-10 20:00:00,226,null,115718,115718,115718,48,27,0,8143,1441,9584
20200428,TX,26171,274213,null,2020-04-28 20:00:00,690,null,300384,300384,300384,48,27,0,8993,874,9867
20200409,TX,10230,95904,null,2020-04-09 20:00:00,199,null,106134,106134,106134,48,22,0,8999,877,9876
20200503,TX,31548,359012,null,2020-05-03 20:00:00,867,null,390560,390560,390560,48,20,0,8886,1026,9912
20200330,TX,2877,33003,null,2020-03-30 20:00:00,34,null,35880,35880,35880,48,0,0,9795,325,10120
20200417,TX,17371,152165,null,2020-04-17 20:00:00,428,null,169536,169536,169536,48,35,0,10073,916,10989
20200422,TX,21069,195714,null,2020-04-22 20:00:00,543,null,216783,216783,216783,48,26,0,10511,873,11384
20200506,TX,34422,404516,null,2020-05-06 20:00:00,948,null,438938,438938,438938,48,42,0,10675,1053,11728
20200509,TX,37860,451434,null,2020-05-09 20:00:00,1049,null,489294,489294,489294,48,45,0,10925,1251,12176
20200510,TX,38869,462907,null,2020-05-10 20:00:00,1088,null,501776,501776,501776,48,39,0,11473,1009,12482
20200426,TX,24631,251390,null,2020-04-26 20:00:00,648,null,276021,276021,276021,48,25,0,12347,858,13205
20200414,TX,14624,131843,null,2020-04-14 20:00:00,318,null,146467,146467,146467,48,31,0,12523,718,13241
20200429,TX,27054,287736,null,2020-04-29 20:00:00,732,null,314790,314790,314790,48,42,0,13523,883,14406
20200406,TX,7276,78081,null,2020-04-06 20:00:00,140,null,85357,85357,85357,48,13,0,13955,464,14419
20200427,TX,25297,265220,null,2020-04-27 20:00:00,663,null,290517,290517,290517,48,15,0,13830,666,14496
20200421,TX,20196,185203,null,2020-04-21 20:00:00,517,null,205399,205399,205399,48,22,0,14267,738,15005
20200430,TX,28087,302213,null,2020-04-30 20:00:00,782,null,330300,330300,330300,48,50,0,14477,1033,15510
20200507,TX,35390,419772,null,2020-05-07 20:00:00,973,null,455162,455162,455162,48,25,0,15256,968,16224
20200504,TX,32332,375066,null,2020-05-04 20:00:00,884,null,407398,407398,407398,48,17,0,16054,784,16838
20200424,TX,22806,219741,null,2020-04-24 20:00:00,593,null,242547,242547,242547,48,32,0,16607,862,17469
20200505,TX,33369,393841,null,2020-05-05 20:00:00,906,null,427210,427210,427210,48,22,0,18775,1037,19812
20200425,TX,23773,239043,null,2020-04-25 20:00:00,623,null,262816,262816,262816,48,30,0,19302,967,20269
20200501,TX,29229,322546,null,2020-05-01 20:00:00,816,null,351775,351775,351775,48,34,0,20333,1142,21475
20200508,TX,36609,440509,null,2020-05-08 20:00:00,1004,null,477118,477118,477118,48,31,0,20737,1219,21956
20200511,TX,39869,485828,null,2020-05-11 20:00:00,1100,null,525697,525697,525697,48,12,0,22921,1000,23921
20200502,TX,30522,350126,null,2020-05-02 20:00:00,847,null,380648,380648,380648,48,31,0,27580,1293,28873
20200304,TX,1,null,null,2020-03-04 21:00:00,null,null,1,1,1,48,null,null,null,null,null
20200314,UT,6,131,null,2020-03-14 20:00:00,null,null,137,137,137,49,0,0,0,0,0
20200311,UT,2,null,null,2020-03-11 20:00:00,null,null,2,2,2,49,0,0,0,0,0
20200309,UT,1,null,null,2020-03-09 20:00:00,null,null,1,1,1,49,0,0,0,0,0
20200308,UT,1,null,null,2020-03-08 20:00:00,null,null,1,1,1,49,0,0,0,0,0
20200310,UT,2,null,null,2020-03-10 20:00:00,null,null,2,2,2,49,0,0,0,1,1
20200313,UT,6,131,null,2020-03-13 20:00:00,null,null,137,137,137,49,0,0,0,2,2
20200316,UT,39,131,null,2020-03-16 20:00:00,0,null,170,170,170,49,0,0,0,11,11
20200318,UT,63,131,null,2020-03-18 20:00:00,0,null,194,194,194,49,0,0,0,12,12
20200317,UT,51,131,null,2020-03-17 20:00:00,0,null,182,182,182,49,0,0,0,12,12
20200315,UT,28,131,null,2020-03-15 20:00:00,0,null,159,159,159,49,0,0,0,22,22
20200402,UT,1074,20155,null,2020-04-02 20:00:00,7,100,21229,21229,21229,49,0,9,0,62,62
20200312,UT,4,131,null,2020-03-12 20:00:00,null,null,135,135,135,49,0,0,131,2,133
20200321,UT,136,2424,null,2020-03-21 20:00:00,0,null,2560,2560,2560,49,0,0,389,24,413
20200320,UT,112,2035,null,2020-03-20 20:00:00,0,null,2147,2147,2147,49,0,0,587,34,621
20200414,UT,2412,44064,null,2020-04-14 20:00:00,19,213,46476,46476,46476,49,1,12,640,49,689
20200324,UT,299,5524,null,2020-03-24 20:00:00,1,null,5823,5823,5823,49,0,0,734,42,776
20200326,UT,402,7308,null,2020-03-26 20:00:00,1,null,7710,7710,7710,49,0,0,817,56,873
20200325,UT,346,6491,null,2020-03-25 20:00:00,1,null,6837,6837,6837,49,0,0,967,47,1014
20200322,UT,181,3508,null,2020-03-22 20:00:00,1,null,3689,3689,3689,49,1,0,1084,45,1129
20200415,UT,2542,45072,null,2020-04-15 20:00:00,20,221,47614,47614,47614,49,1,8,1008,130,1138
20200407,UT,1738,32909,null,2020-04-07 20:00:00,13,148,34647,34647,34647,49,0,10,1190,63,1253
20200319,UT,78,1448,null,2020-03-19 20:00:00,0,null,1526,1526,1526,49,0,0,1317,15,1332
20200323,UT,257,4790,null,2020-03-23 20:00:00,1,null,5047,5047,5047,49,0,0,1282,76,1358
20200408,UT,1846,34270,null,2020-04-08 20:00:00,13,158,36116,36116,36116,49,0,10,1361,108,1469
20200327,UT,480,8764,null,2020-03-27 20:00:00,2,null,9244,9244,9244,49,1,0,1456,78,1534
20200413,UT,2363,43424,null,2020-04-13 20:00:00,18,201,45787,45787,45787,49,0,6,1493,60,1553
20200412,UT,2303,41931,null,2020-04-12 20:00:00,18,195,44234,44234,44234,49,0,5,1591,97,1688
20200411,UT,2206,40340,null,2020-04-11 20:00:00,18,190,42546,42546,42546,49,1,7,1680,104,1784
20200330,UT,806,15197,null,2020-03-30 20:00:00,4,null,16003,16003,16003,49,2,0,1923,87,2010
20200505,UT,5449,121266,null,2020-05-05 20:00:00,56,456,126715,126715,126715,49,6,15,1922,132,2054
20200416,UT,2683,46995,null,2020-04-16 20:00:00,21,238,49678,49678,49678,49,1,17,1923,141,2064
20200328,UT,602,10710,null,2020-03-28 20:00:00,2,null,11312,11312,11312,49,0,0,1946,122,2068
20200428,UT,4343,98096,null,2020-04-28 20:00:00,45,370,102439,102439,102439,49,4,21,2134,110,2244
20200409,UT,1976,36397,null,2020-04-09 20:00:00,13,168,38373,38373,38373,49,0,10,2127,130,2257
20200410,UT,2102,38660,null,2020-04-10 20:00:00,17,183,40762,40762,40762,49,4,15,2263,126,2389
20200406,UT,1675,31719,null,2020-04-06 20:00:00,13,138,33394,33394,33394,49,5,14,2432,70,2502
20200331,UT,887,17626,null,2020-03-31 20:00:00,5,73,18513,18513,18513,49,1,73,2429,81,2510
20200504,UT,5317,119344,null,2020-05-04 20:00:00,50,441,124661,124661,124661,49,0,5,2417,142,2559
20200401,UT,1012,20155,null,2020-04-01 20:00:00,7,91,21167,21167,21167,49,2,18,2529,125,2654
20200329,UT,719,13274,null,2020-03-29 20:00:00,2,null,13993,13993,13993,49,0,0,2564,117,2681
20200430,UT,4672,103829,null,2020-04-30 20:00:00,46,390,108501,108501,108501,49,1,7,2546,177,2723
20200405,UT,1605,29287,null,2020-04-05 20:00:00,8,124,30892,30892,30892,49,0,7,2672,177,2849
20200403,UT,1246,23002,null,2020-04-03 20:00:00,7,106,24248,24248,24248,49,0,6,2847,172,3019
20200510,UT,6251,140259,null,2020-05-10 20:00:00,67,512,146510,146510,146510,49,1,14,3068,148,3216
20200429,UT,4495,101283,null,2020-04-29 20:00:00,45,383,105778,105778,105778,49,0,13,3187,152,3339
20200507,UT,5724,128819,null,2020-05-07 20:00:00,61,476,134543,134543,134543,49,3,12,3412,129,3541
20200419,UT,3069,60486,null,2020-04-19 20:00:00,27,259,63555,63555,63555,49,2,8,3473,138,3611
20200404,UT,1428,26615,null,2020-04-04 20:00:00,8,117,28043,28043,28043,49,1,11,3613,182,3795
20200421,UT,3296,69062,null,2020-04-21 20:00:00,32,277,72358,72358,72358,49,4,9,3964,83,4047
20200501,UT,4828,107730,null,2020-05-01 20:00:00,46,403,112558,112558,112558,49,0,13,3901,156,4057
20200424,UT,3782,80915,null,2020-04-24 20:00:00,39,315,84697,84697,84697,49,4,14,3900,170,4070
20200511,UT,6362,144223,null,2020-05-11 20:00:00,68,517,150585,150585,150585,49,1,5,3964,111,4075
20200422,UT,3445,73015,null,2020-04-22 20:00:00,34,288,76460,76460,76460,49,2,11,3953,149,4102
20200508,UT,5919,132769,null,2020-05-08 20:00:00,61,488,138688,138688,138688,49,0,12,3950,195,4145
20200423,UT,3612,77015,null,2020-04-23 20:00:00,35,301,80627,80627,80627,49,1,13,4000,167,4167
20200418,UT,2931,57013,null,2020-04-18 20:00:00,25,251,59944,59944,59944,49,2,7,4047,126,4173
20200506,UT,5595,125407,null,2020-05-06 20:00:00,58,464,131002,131002,131002,49,2,8,4141,146,4287
20200503,UT,5175,116927,null,2020-05-03 20:00:00,50,436,122102,122102,122102,49,1,18,4104,194,4298
20200427,UT,4233,95962,null,2020-04-27 20:00:00,41,349,100195,100195,100195,49,0,4,4383,110,4493
20200509,UT,6103,137191,null,2020-05-09 20:00:00,66,498,143294,143294,143294,49,5,10,4422,184,4606
20200420,UT,3213,65098,null,2020-04-20 20:00:00,28,268,68311,68311,68311,49,1,9,4612,144,4756
20200502,UT,4981,112823,null,2020-05-02 20:00:00,49,418,117804,117804,117804,49,3,15,5093,153,5246
20200426,UT,4123,91579,null,2020-04-26 20:00:00,41,345,95702,95702,95702,49,0,16,5321,175,5496
20200425,UT,3948,86258,null,2020-04-25 20:00:00,41,329,90206,90206,90206,49,2,14,5343,166,5509
20200417,UT,2805,52966,null,2020-04-17 20:00:00,23,244,55771,55771,55771,49,2,6,5971,122,6093
20200307,UT,1,null,null,2020-03-07 21:00:00,null,null,1,1,1,49,null,null,null,null,null
20200502,VA,17731,84365,458,2020-05-02 20:00:00,616,3738,102554,102096,102096,51,35,84,-5174,830,-4344
20200506,VA,20256,93452,469,2020-05-06 20:00:00,713,4113,114177,113708,113708,51,0,0,0,0,0
20200314,VA,30,117,null,2020-03-14 20:00:00,null,null,147,147,147,51,0,0,0,0,0
20200309,VA,3,38,9,2020-03-09 20:00:00,null,null,50,41,41,51,0,0,2,1,3
20200306,VA,0,21,10,2020-03-06 21:00:00,null,null,31,21,21,51,0,0,3,0,3
20200308,VA,2,36,6,2020-03-08 20:00:00,null,null,44,38,38,51,0,0,5,2,7
20200311,VA,9,60,null,2020-03-11 20:00:00,null,null,69,69,69,51,0,0,7,1,8
20200307,VA,0,31,7,2020-03-07 21:00:00,null,null,38,31,31,51,0,0,10,0,10
20200313,VA,30,117,null,2020-03-13 20:00:00,null,null,147,147,147,51,0,0,0,13,13
20200310,VA,8,53,null,2020-03-10 20:00:00,null,null,61,61,61,51,0,0,15,5,20
20200312,VA,17,117,null,2020-03-12 20:00:00,null,null,134,134,134,51,0,0,57,8,65
20200316,VA,51,438,null,2020-03-16 20:00:00,1,null,489,489,489,51,0,0,75,6,81
20200318,VA,77,1201,null,2020-03-18 20:00:00,1,null,1278,1278,1278,51,0,0,240,10,250
20200315,VA,45,363,null,2020-03-15 20:00:00,1,null,408,408,408,51,1,0,246,15,261
20200323,VA,254,3443,null,2020-03-23 20:00:00,6,38,3697,3697,3697,51,3,6,325,35,360
20200320,VA,114,2211,null,2020-03-20 20:00:00,2,null,2325,2325,2325,51,0,0,382,20,402
20200321,VA,152,2638,null,2020-03-21 20:00:00,2,25,2790,2790,2790,51,0,25,427,38,465
20200317,VA,67,961,null,2020-03-17 20:00:00,1,null,1028,1028,1028,51,0,0,523,16,539
20200322,VA,219,3118,null,2020-03-22 20:00:00,3,32,3337,3337,3337,51,1,7,480,67,547
20200319,VA,94,1829,null,2020-03-19 20:00:00,2,null,1923,1923,1923,51,1,0,628,17,645
20200324,VA,290,4180,null,2020-03-24 20:00:00,7,45,4470,4470,4470,51,1,7,737,36,773
20200326,VA,460,5729,null,2020-03-26 20:00:00,13,65,6189,6189,6189,51,4,6,750,69,819
20200406,VA,2878,21643,null,2020-04-06 20:00:00,54,497,24521,24521,24521,51,3,66,609,241,850
20200325,VA,391,4979,null,2020-03-25 20:00:00,9,59,5370,5370,5370,51,2,14,799,101,900
20200327,VA,604,6733,null,2020-03-27 20:00:00,14,83,7337,7337,7337,51,1,18,1004,144,1148
20200414,VA,6171,36592,469,2020-04-14 20:00:00,154,null,43232,42763,42763,51,5,0,938,424,1362
20200331,VA,1250,12151,null,2020-03-31 20:00:00,27,165,13401,13401,13401,51,2,29,1133,230,1363
20200415,VA,6500,37669,496,2020-04-15 20:00:00,195,1048,44665,44169,44169,51,41,1048,1077,329,1406
20200505,VA,20256,93452,469,2020-05-05 20:00:00,713,4113,114177,113708,113708,51,29,103,651,764,1415
20200413,VA,5747,35654,473,2020-04-13 20:00:00,149,null,41874,41401,41401,51,8,0,943,473,1416
20200403,VA,2012,16993,null,2020-04-03 20:00:00,46,312,19005,19005,19005,51,5,7,1110,306,1416
20200330,VA,1020,11018,null,2020-03-30 20:00:00,25,136,12038,12038,12038,51,3,24,1299,130,1429
20200329,VA,890,9719,null,2020-03-29 20:00:00,22,112,10609,10609,10609,51,5,13,1292,151,1443
20200421,VA,9630,48724,477,2020-04-21 20:00:00,324,1581,58831,58354,58354,51,24,81,979,640,1619
20200328,VA,739,8427,null,2020-03-28 20:00:00,17,99,9166,9166,9166,51,3,16,1694,135,1829
20200401,VA,1484,13860,null,2020-04-01 20:00:00,34,305,15344,15344,15344,51,7,140,1709,234,1943
20200412,VA,5274,34711,521,2020-04-12 20:00:00,141,null,40506,39985,39985,51,11,0,1789,197,1986
20200408,VA,3645,27000,null,2020-04-08 20:00:00,75,615,30645,30645,30645,51,12,52,1688,312,2000
20200420,VA,8990,47745,468,2020-04-20 20:00:00,300,1500,57203,56735,56735,51,23,78,1549,453,2002
20200405,VA,2637,21034,null,2020-04-05 20:00:00,51,431,23671,23671,23671,51,-1,41,1889,230,2119
20200402,VA,1706,15883,null,2020-04-02 20:00:00,41,305,17589,17589,17589,51,7,0,2023,222,2245
20200416,VA,6889,39555,537,2020-04-16 20:00:00,208,1114,46981,46444,46444,51,13,66,1886,389,2275
20200409,VA,4042,28984,627,2020-04-09 20:00:00,109,685,33653,33026,33026,51,34,70,1984,397,2381
20200422,VA,10266,50512,477,2020-04-22 20:00:00,349,1659,61255,60778,60778,51,25,78,1788,636,2424
20200410,VA,4509,30950,521,2020-04-10 20:00:00,121,772,35980,35459,35459,51,12,87,1966,467,2433
20200411,VA,5077,32922,517,2020-04-11 20:00:00,130,null,38516,37999,37999,51,9,0,1972,568,2540
20200404,VA,2407,19145,null,2020-04-04 20:00:00,52,390,21552,21552,21552,51,6,78,2152,395,2547
20200417,VA,7491,41506,499,2020-04-17 20:00:00,231,1221,49496,48997,48997,51,23,107,1951,602,2553
20200428,VA,14339,68959,560,2020-04-28 20:00:00,492,3422,83858,83298,83298,51,34,124,1815,804,2619
20200429,VA,14961,70979,620,2020-04-29 20:00:00,522,3608,86560,85940,85940,51,30,186,2020,622,2642
20200419,VA,8537,46196,499,2020-04-19 20:00:00,277,1422,55232,54733,54733,51,19,126,2318,484,2802
20200418,VA,8053,43878,486,2020-04-18 20:00:00,258,1296,52417,51931,51931,51,27,75,2372,562,2934
20200425,VA,12366,60276,1405,2020-04-25 20:00:00,436,1942,74047,72642,72642,51,26,105,2430,772,3202
20200426,VA,12970,63630,539,2020-04-26 20:00:00,448,2014,77139,76600,76600,51,12,72,3354,604,3958
20200427,VA,13535,67144,542,2020-04-27 20:00:00,458,3298,81221,80679,80679,51,10,1284,3514,565,4079
20200423,VA,10998,53891,492,2020-04-23 20:00:00,372,1753,65381,64889,64889,51,23,94,3379,732,4111
20200407,VA,3333,25312,null,2020-04-07 20:00:00,63,563,28645,28645,28645,51,9,66,3669,455,4124
20200504,VA,19492,92801,478,2020-05-04 20:00:00,684,4010,112771,112293,112293,51,24,100,3470,821,4291
20200424,VA,11594,57846,487,2020-04-24 20:00:00,410,1837,69927,69440,69440,51,38,84,3955,596,4551
20200430,VA,15846,75663,583,2020-04-30 20:00:00,552,3654,92092,91509,91509,51,30,46,4684,885,5569
20200510,VA,24081,118974,506,2020-05-10 20:00:00,839,4756,143561,143055,143055,51,12,39,5021,885,5906
20200503,VA,18671,89331,465,2020-05-03 20:00:00,660,3910,108467,108002,108002,51,44,172,4966,940,5906
20200508,VA,22342,107603,549,2020-05-08 20:00:00,812,4622,130494,129945,129945,51,43,184,6021,772,6793
20200509,VA,23196,113953,501,2020-05-09 20:00:00,827,4717,137650,137149,137149,51,15,95,6350,854,7204
20200511,VA,25070,125547,432,2020-05-11 20:00:00,850,4777,151049,150617,150617,51,11,21,6573,989,7562
20200507,VA,21570,101582,519,2020-05-07 20:00:00,769,4438,123671,123152,123152,51,56,325,8130,1314,9444
20200501,VA,16901,89539,468,2020-05-01 20:00:00,581,3654,106908,106440,106440,51,29,0,13876,1055,14931
20200305,VA,0,18,3,2020-03-05 21:00:00,null,null,21,18,18,51,null,null,null,null,null
20200509,VI,68,1024,36,2020-05-09 20:00:00,4,null,1128,1092,1092,78,0,0,0,0,0
20200507,VI,66,990,37,2020-05-07 20:00:00,4,null,1093,1056,1056,78,0,0,0,0,0
20200423,VI,54,583,31,2020-04-23 20:00:00,3,null,668,637,637,78,0,0,0,0,0
20200412,VI,51,299,20,2020-04-12 20:00:00,1,null,370,350,350,78,0,0,0,0,0
20200407,VI,43,222,20,2020-04-07 20:00:00,1,null,285,265,265,78,0,0,0,0,0
20200401,VI,30,126,24,2020-04-01 20:00:00,null,null,180,156,156,78,0,0,0,0,0
20200331,VI,30,126,24,2020-03-31 20:00:00,null,null,180,156,156,78,0,0,0,0,0
20200326,VI,17,55,2,2020-03-26 20:00:00,null,null,74,72,72,78,0,0,0,0,0
20200324,VI,17,null,null,2020-03-24 20:00:00,null,null,17,17,17,78,0,0,0,0,0
20200322,VI,6,null,null,2020-03-22 20:00:00,null,null,6,6,6,78,0,0,0,0,0
20200320,VI,3,null,null,2020-03-20 20:00:00,null,null,3,3,3,78,0,0,0,0,0
20200318,VI,2,null,null,2020-03-18 20:00:00,null,null,2,2,2,78,0,0,0,0,0
20200319,VI,3,null,null,2020-03-19 20:00:00,null,null,3,3,3,78,0,0,0,1,1
20200317,VI,2,null,null,2020-03-17 20:00:00,null,null,2,2,2,78,0,0,0,1,1
20200327,VI,19,55,2,2020-03-27 20:00:00,null,null,76,74,74,78,0,0,0,2,2
20200428,VI,59,719,57,2020-04-28 20:00:00,4,null,835,778,778,78,0,0,3,0,3
20200321,VI,6,null,null,2020-03-21 20:00:00,null,null,6,6,6,78,0,0,0,3,3
20200501,VI,66,811,68,2020-05-01 20:00:00,4,null,945,877,877,78,0,0,4,0,4
20200414,VI,51,326,23,2020-04-14 20:00:00,1,null,400,377,377,78,0,0,4,0,4
20200415,VI,51,331,35,2020-04-15 20:00:00,1,null,417,382,382,78,0,0,5,0,5
20200420,VI,53,554,18,2020-04-20 20:00:00,3,null,625,607,607,78,0,0,6,0,6
20200511,VI,69,1110,36,2020-05-11 20:00:00,5,null,1215,1179,1179,78,1,0,8,0,8
20200505,VI,66,973,34,2020-05-05 20:00:00,4,null,1073,1039,1039,78,0,0,8,0,8
20200426,VI,57,700,19,2020-04-26 20:00:00,4,null,776,757,757,78,1,0,7,2,9
20200422,VI,54,583,31,2020-04-22 20:00:00,3,null,668,637,637,78,0,0,9,0,9
20200409,VI,46,251,42,2020-04-09 20:00:00,1,null,339,297,297,78,0,0,9,1,10
20200403,VI,38,154,56,2020-04-03 20:00:00,null,null,248,192,192,78,0,0,5,5,10
20200330,VI,30,126,24,2020-03-30 20:00:00,null,null,180,156,156,78,0,0,3,7,10
20200323,VI,17,null,null,2020-03-23 20:00:00,null,null,17,17,17,78,0,0,0,11,11
20200504,VI,66,965,15,2020-05-04 20:00:00,4,null,1046,1031,1031,78,0,0,14,0,14
20200429,VI,62,732,78,2020-04-29 20:00:00,4,null,872,794,794,78,0,0,13,3,16
20200417,VI,51,373,34,2020-04-17 20:00:00,2,null,458,424,424,78,1,0,16,0,16
20200506,VI,66,990,37,2020-05-06 20:00:00,4,null,1093,1056,1056,78,0,0,17,0,17
20200406,VI,43,222,20,2020-04-06 20:00:00,1,null,285,265,265,78,0,0,16,1,17
20200427,VI,59,716,5,2020-04-27 20:00:00,4,null,780,775,775,78,0,0,16,2,18
20200329,VI,23,123,37,2020-03-29 20:00:00,null,null,183,146,146,78,0,0,17,1,18
20200418,VI,53,390,35,2020-04-18 20:00:00,3,null,478,443,443,78,1,0,17,2,19
20200421,VI,54,574,35,2020-04-21 20:00:00,3,null,663,628,628,78,0,0,20,1,21
20200408,VI,45,242,35,2020-04-08 20:00:00,1,null,322,287,287,78,0,0,20,2,22
20200413,VI,51,322,2,2020-04-13 20:00:00,1,null,375,373,373,78,0,0,23,0,23
20200405,VI,42,206,18,2020-04-05 20:00:00,1,null,266,248,248,78,1,0,22,2,24
20200416,VI,51,357,35,2020-04-16 20:00:00,1,null,443,408,408,78,0,0,26,0,26
20200410,VI,50,273,45,2020-04-10 20:00:00,1,null,368,323,323,78,0,0,22,4,26
20200402,VI,33,149,42,2020-04-02 20:00:00,null,null,224,182,182,78,0,0,23,3,26
20200411,VI,51,299,20,2020-04-11 20:00:00,1,null,370,350,350,78,0,0,26,1,27
20200503,VI,66,951,29,2020-05-03 20:00:00,4,null,1046,1017,1017,78,0,0,29,0,29
20200404,VI,40,184,42,2020-04-04 20:00:00,null,null,266,224,224,78,0,0,30,2,32
20200508,VI,68,1024,36,2020-05-08 20:00:00,4,null,1128,1092,1092,78,0,0,34,2,36
20200425,VI,55,693,22,2020-04-25 20:00:00,3,null,770,748,748,78,0,0,51,1,52
20200328,VI,22,106,55,2020-03-28 20:00:00,null,null,183,128,128,78,0,0,51,3,54
20200325,VI,17,55,2,2020-03-25 20:00:00,null,null,74,72,72,78,0,0,55,0,55
20200424,VI,54,642,35,2020-04-24 20:00:00,3,null,731,696,696,78,0,0,59,0,59
20200510,VI,69,1102,39,2020-05-10 20:00:00,4,null,1210,1171,1171,78,0,0,78,1,79
20200430,VI,66,807,43,2020-04-30 20:00:00,4,null,916,873,873,78,0,0,75,4,79
20200502,VI,66,922,54,2020-05-02 20:00:00,4,null,1042,988,988,78,0,0,111,0,111
20200419,VI,53,548,22,2020-04-19 20:00:00,3,null,623,601,601,78,0,0,158,0,158
20200316,VI,1,null,null,2020-03-16 20:00:00,null,null,1,1,1,78,null,null,null,null,null
20200321,VT,29,779,null,2020-03-21 20:00:00,2,null,808,808,808,50,0,0,0,0,0
20200310,VT,1,40,null,2020-03-10 20:00:00,null,null,41,41,41,50,0,0,6,0,6
20200309,VT,1,34,null,2020-03-09 20:00:00,null,null,35,35,35,50,0,0,6,0,6
20200307,VT,0,16,null,2020-03-07 21:00:00,null,null,16,16,16,50,0,0,8,0,8
20200308,VT,1,28,null,2020-03-08 20:00:00,null,null,29,29,29,50,0,0,12,1,13
20200311,VT,1,62,null,2020-03-11 20:00:00,null,null,63,63,63,50,0,0,22,0,22
20200323,VT,75,1106,null,2020-03-23 20:00:00,5,null,1181,1181,1181,50,3,0,0,23,23
20200312,VT,2,97,null,2020-03-12 20:00:00,null,null,99,99,99,50,0,0,35,1,36
20200313,VT,2,142,null,2020-03-13 20:00:00,null,null,144,144,144,50,0,0,45,0,45
20200410,VT,679,7553,null,2020-04-10 20:00:00,24,null,8232,8232,8232,50,1,0,0,51,51
20200406,VT,543,6090,null,2020-04-06 20:00:00,23,45,6633,6633,6633,50,1,0,20,31,51
20200319,VT,22,645,null,2020-03-19 20:00:00,null,null,667,667,667,50,0,0,53,3,56
20200317,VT,10,495,null,2020-03-17 20:00:00,null,null,505,505,505,50,0,0,74,2,76
20200316,VT,8,421,null,2020-03-16 20:00:00,null,null,429,429,429,50,0,0,73,4,77
20200314,VT,4,227,null,2020-03-14 20:00:00,null,null,231,231,231,50,0,0,85,2,87
20200318,VT,19,592,null,2020-03-18 20:00:00,null,null,611,611,611,50,0,0,97,9,106
20200328,VT,211,2163,null,2020-03-28 20:00:00,12,18,2374,2374,2374,50,2,0,86,27,113
20200426,VT,851,13946,null,2020-04-26 20:00:00,46,null,14797,14797,14797,50,0,0,107,8,115
20200315,VT,4,348,null,2020-03-15 20:00:00,null,null,352,352,352,50,0,0,121,0,121
20200421,VT,818,12293,null,2020-04-21 20:00:00,40,null,13111,13111,13111,50,2,0,128,2,130
20200320,VT,29,779,null,2020-03-20 20:00:00,2,null,808,808,808,50,2,0,134,7,141
20200428,VT,862,14353,null,2020-04-28 20:00:00,47,null,15215,15215,15215,50,0,0,135,7,142
20200419,VT,812,11914,null,2020-04-19 20:00:00,38,null,12726,12726,12726,50,0,0,151,9,160
20200325,VT,123,1589,null,2020-03-25 20:00:00,8,null,1712,1712,1712,50,1,0,149,28,177
20200403,VT,389,4839,null,2020-04-03 20:00:00,17,45,5228,5228,5228,50,0,0,128,51,179
20200505,VT,907,16611,null,2020-05-05 20:00:00,52,null,17518,17518,17518,50,0,0,181,5,186
20200429,VT,862,14567,null,2020-04-29 20:00:00,47,null,15429,15429,15429,50,0,0,214,0,214
20200414,VT,752,9833,null,2020-04-14 20:00:00,29,null,10585,10585,10585,50,1,0,215,4,219
20200430,VT,866,14786,null,2020-04-30 20:00:00,49,null,15652,15652,15652,50,2,0,219,4,223
20200330,VT,256,3674,null,2020-03-30 20:00:00,12,18,3930,3930,3930,50,0,0,208,21,229
20200401,VT,321,4174,null,2020-04-01 20:00:00,16,45,4495,4495,4495,50,3,9,217,28,245
20200327,VT,184,2077,null,2020-03-27 20:00:00,10,18,2261,2261,2261,50,1,18,227,26,253
20200420,VT,816,12165,null,2020-04-20 20:00:00,38,null,12981,12981,12981,50,0,0,251,4,255
20200427,VT,855,14218,null,2020-04-27 20:00:00,47,null,15073,15073,15073,50,1,0,272,4,276
20200326,VT,158,1850,null,2020-03-26 20:00:00,9,null,2008,2008,2008,50,1,0,261,35,296
20200331,VT,293,3957,null,2020-03-31 20:00:00,13,36,4250,4250,4250,50,1,18,283,37,320
20200322,VT,52,1106,null,2020-03-22 20:00:00,2,null,1158,1158,1158,50,0,0,327,23,350
20200422,VT,823,12639,null,2020-04-22 20:00:00,40,null,13462,13462,13462,50,0,0,346,5,351
20200324,VT,95,1440,null,2020-03-24 20:00:00,7,null,1535,1535,1535,50,2,0,334,20,354
20200506,VT,908,16968,null,2020-05-06 20:00:00,52,null,17876,17876,17876,50,0,0,357,1,358
20200502,VT,886,15705,null,2020-05-02 20:00:00,51,null,16591,16591,16591,50,1,0,351,7,358
20200503,VT,897,16057,null,2020-05-03 20:00:00,52,null,16954,16954,16954,50,1,0,352,11,363
20200425,VT,843,13839,null,2020-04-25 20:00:00,46,null,14682,14682,14682,50,2,0,356,16,372
20200504,VT,902,16430,null,2020-05-04 20:00:00,52,null,17332,17332,17332,50,0,0,373,5,378
20200423,VT,825,13027,null,2020-04-23 20:00:00,43,null,13852,13852,13852,50,3,0,388,2,390
20200416,VT,768,10739,null,2020-04-16 20:00:00,35,null,11507,11507,11507,50,5,0,417,9,426
20200409,VT,628,7553,null,2020-04-09 20:00:00,23,null,8181,8181,8181,50,0,0,409,23,432
20200418,VT,803,11763,null,2020-04-18 20:00:00,38,null,12566,12566,12566,50,3,0,426,24,450
20200424,VT,827,13483,null,2020-04-24 20:00:00,44,null,14310,14310,14310,50,1,0,456,2,458
20200415,VT,759,10322,null,2020-04-15 20:00:00,30,null,11081,11081,11081,50,1,0,489,7,496
20200407,VT,575,6554,null,2020-04-07 20:00:00,23,45,7129,7129,7129,50,0,0,464,32,496
20200509,VT,921,18606,null,2020-05-09 20:00:00,53,null,19527,19527,19527,50,0,0,517,2,519
20200510,VT,927,19121,null,2020-05-10 20:00:00,53,null,20048,20048,20048,50,0,0,515,6,521
20200413,VT,748,9618,null,2020-04-13 20:00:00,28,null,10366,10366,10366,50,1,0,504,21,525
20200402,VT,338,4711,null,2020-04-02 20:00:00,17,45,5049,5049,5049,50,1,0,537,17,554
20200508,VT,919,18089,null,2020-05-08 20:00:00,53,null,19008,19008,19008,50,0,0,554,3,557
20200507,VT,916,17535,null,2020-05-07 20:00:00,53,null,18451,18451,18451,50,1,0,567,8,575
20200501,VT,879,15354,null,2020-05-01 20:00:00,50,null,16233,16233,16233,50,1,0,568,13,581
20200412,VT,727,9114,null,2020-04-12 20:00:00,27,null,9841,9841,9841,50,2,0,567,16,583
20200417,VT,779,11337,null,2020-04-17 20:00:00,35,null,12116,12116,12116,50,0,0,598,11,609
20200404,VT,461,5383,null,2020-04-04 20:00:00,20,45,5844,5844,5844,50,3,0,544,72,616
20200408,VT,605,7144,null,2020-04-08 20:00:00,23,50,7749,7749,7749,50,0,5,590,30,620
20200405,VT,512,6070,null,2020-04-05 20:00:00,22,45,6582,6582,6582,50,2,0,687,51,738
20200511,VT,926,19945,null,2020-05-11 20:00:00,53,null,20871,20871,20871,50,0,0,824,-1,823
20200411,VT,711,8547,null,2020-04-11 20:00:00,25,null,9258,9258,9258,50,1,0,994,32,1026
20200329,VT,235,3466,null,2020-03-29 20:00:00,12,18,3701,3701,3701,50,0,0,1303,24,1327
20200306,VT,0,8,null,2020-03-06 21:00:00,null,null,8,8,8,50,null,null,null,null,null
20200426,WA,13521,161919,null,2020-04-26 20:00:00,738,null,175440,175440,175440,53,73,0,0,0,0
20200227,WA,2,null,null,2020-02-27 21:00:00,2,null,2,2,2,53,0,0,0,0,0
20200226,WA,2,null,null,2020-02-26 21:00:00,2,null,2,2,2,53,2,0,0,0,0
20200225,WA,2,null,null,2020-02-25 21:00:00,null,null,2,2,2,53,0,0,0,0,0
20200224,WA,2,null,null,2020-02-24 21:00:00,null,null,2,2,2,53,0,0,0,0,0
20200223,WA,2,null,null,2020-02-23 21:00:00,null,null,2,2,2,53,0,0,0,0,0
20200222,WA,2,null,null,2020-02-22 21:00:00,null,null,2,2,2,53,0,0,0,0,0
20200221,WA,2,null,null,2020-02-21 21:00:00,null,null,2,2,2,53,0,0,0,0,0
20200220,WA,2,null,null,2020-02-20 21:00:00,null,null,2,2,2,53,0,0,0,0,0
20200219,WA,2,null,null,2020-02-19 21:00:00,null,null,2,2,2,53,0,0,0,0,0
20200218,WA,2,null,null,2020-02-18 21:00:00,null,null,2,2,2,53,0,0,0,0,0
20200217,WA,2,null,null,2020-02-17 21:00:00,null,null,2,2,2,53,0,0,0,0,0
20200216,WA,2,null,null,2020-02-16 21:00:00,null,null,2,2,2,53,0,0,0,0,0
20200215,WA,2,null,null,2020-02-15 21:00:00,null,null,2,2,2,53,0,0,0,0,0
20200214,WA,2,null,null,2020-02-14 21:00:00,null,null,2,2,2,53,0,0,0,0,0
20200213,WA,2,null,null,2020-02-13 21:00:00,null,null,2,2,2,53,0,0,0,0,0
20200212,WA,2,null,null,2020-02-12 21:00:00,null,null,2,2,2,53,0,0,0,0,0
20200211,WA,2,null,null,2020-02-11 21:00:00,null,null,2,2,2,53,0,0,0,0,0
20200210,WA,2,null,null,2020-02-10 21:00:00,null,null,2,2,2,53,0,0,0,0,0
20200209,WA,2,null,null,2020-02-09 21:00:00,null,null,2,2,2,53,0,0,0,0,0
20200208,WA,2,null,null,2020-02-08 21:00:00,null,null,2,2,2,53,0,0,0,0,0
20200206,WA,1,null,null,2020-02-06 21:00:00,null,null,1,1,1,53,0,0,0,0,0
20200205,WA,1,null,null,2020-02-05 21:00:00,null,null,1,1,1,53,0,0,0,0,0
20200204,WA,1,null,null,2020-02-04 21:00:00,null,null,1,1,1,53,0,0,0,0,0
20200203,WA,1,null,null,2020-02-03 21:00:00,null,null,1,1,1,53,0,0,0,0,0
20200202,WA,1,null,null,2020-02-02 21:00:00,null,null,1,1,1,53,0,0,0,0,0
20200201,WA,1,null,null,2020-02-01 21:00:00,null,null,1,1,1,53,0,0,0,0,0
20200131,WA,1,null,null,2020-01-31 21:00:00,null,null,1,1,1,53,0,0,0,0,0
20200130,WA,1,null,null,2020-01-30 21:00:00,null,null,1,1,1,53,0,0,0,0,0
20200129,WA,1,null,null,2020-01-29 21:00:00,null,null,1,1,1,53,0,0,0,0,0
20200128,WA,1,null,null,2020-01-28 21:00:00,null,null,1,1,1,53,0,0,0,0,0
20200127,WA,1,null,null,2020-01-27 21:00:00,null,null,1,1,1,53,0,0,0,0,0
20200126,WA,1,null,null,2020-01-26 21:00:00,null,null,1,1,1,53,0,0,0,0,0
20200125,WA,1,null,null,2020-01-25 21:00:00,null,null,1,1,1,53,0,0,0,0,0
20200124,WA,1,null,null,2020-01-24 21:00:00,null,null,1,1,1,53,0,0,0,0,0
20200123,WA,1,null,null,2020-01-23 21:00:00,null,null,1,1,1,53,0,0,0,0,0
20200207,WA,2,null,null,2020-02-07 21:00:00,null,null,2,2,2,53,0,0,0,1,1
20200228,WA,9,null,null,2020-02-28 21:00:00,4,null,9,9,9,53,2,0,0,7,7
20200229,WA,18,23,null,2020-02-29 21:00:00,5,null,41,41,41,53,1,0,23,9,32
20200427,WA,13521,161956,null,2020-04-27 20:00:00,749,null,175477,175477,175477,53,11,0,37,0,37
20200301,WA,30,81,null,2020-03-01 21:00:00,8,null,111,111,111,53,3,0,58,12,70
20200302,WA,34,229,null,2020-03-02 21:00:00,11,null,263,263,263,53,3,0,148,4,152
20200304,WA,76,631,null,2020-03-04 21:00:00,16,null,707,707,707,53,2,0,204,18,222
20200303,WA,58,427,null,2020-03-03 21:00:00,14,null,485,485,485,53,3,0,198,24,222
20200305,WA,97,943,null,2020-03-05 21:00:00,20,null,1040,1040,1040,53,4,0,312,21,333
20200307,WA,182,1746,66,2020-03-07 21:00:00,27,null,1994,1928,1928,53,1,0,368,32,400
20200306,WA,150,1378,null,2020-03-06 21:00:00,26,null,1528,1528,1528,53,6,0,435,53,488
20200308,WA,249,2208,60,2020-03-08 20:00:00,31,null,2517,2457,2457,53,4,0,462,67,529
20200425,WA,13521,161919,null,2020-04-25 20:00:00,665,null,175440,175440,175440,53,6,0,386,224,610
20200309,WA,349,3173,null,2020-03-09 20:00:00,35,null,3522,3522,3522,53,4,0,965,100,1065
20200412,WA,10398,119533,null,2020-04-12 20:00:00,509,null,129931,129931,129931,53,15,0,1297,236,1533
20200419,WA,12146,142208,null,2020-04-19 20:00:00,615,null,154354,154354,154354,53,17,0,1399,259,1658
20200315,WA,939,18372,null,2020-03-15 20:00:00,57,null,19311,19311,19311,53,6,0,1589,133,1722
20200310,WA,397,4850,null,2020-03-10 20:00:00,37,null,5247,5247,5247,53,2,0,1677,48,1725
20200322,WA,2284,43640,null,2020-03-22 20:00:00,126,null,45924,45924,45924,53,15,0,1704,242,1946
20200329,WA,5121,69788,null,2020-03-29 20:00:00,237,null,74909,74909,74909,53,17,0,1586,384,1970
20200411,WA,10162,118236,null,2020-04-11 20:00:00,494,null,128398,128398,128398,53,18,0,1840,221,2061
20200405,WA,8181,95286,null,2020-04-05 20:00:00,386,null,103467,103467,103467,53,21,0,1757,389,2146
20200311,WA,481,6977,null,2020-03-11 20:00:00,40,null,7458,7458,7458,53,3,0,2127,84,2211
20200418,WA,11887,140809,null,2020-04-18 20:00:00,598,null,152696,152696,152696,53,13,0,2038,214,2252
20200314,WA,806,16783,null,2020-03-14 20:00:00,51,null,17589,17589,17589,53,4,0,2185,104,2289
20200321,WA,2042,41936,null,2020-03-21 20:00:00,111,null,43978,43978,43978,53,7,0,2108,238,2346
20200404,WA,7792,93529,null,2020-04-04 20:00:00,365,null,101321,101321,101321,53,27,0,2345,368,2713
20200328,WA,4737,68202,null,2020-03-28 20:00:00,220,null,72939,72939,72939,53,21,0,2315,432,2747
20200429,WA,13842,168673,null,2020-04-29 20:00:00,786,null,182515,182515,182515,53,21,0,2680,156,2836
20200506,WA,15594,203859,null,2020-05-06 20:00:00,862,null,219453,219453,219453,53,21,0,3001,132,3133
20200424,WA,13297,161533,null,2020-04-24 20:00:00,659,null,174830,174830,174830,53,5,0,2897,302,3199
20200312,WA,551,10571,null,2020-03-12 20:00:00,44,null,11122,11122,11122,53,4,0,3594,70,3664
20200423,WA,12995,158636,null,2020-04-23 20:00:00,654,null,171631,171631,171631,53,7,0,3457,210,3667
20200413,WA,10587,123281,null,2020-04-13 20:00:00,526,null,133868,133868,133868,53,17,0,3748,189,3937
20200409,WA,9492,112544,null,2020-04-09 20:00:00,459,null,122036,122036,122036,53,16,0,3697,278,3975
20200320,WA,1804,39828,null,2020-03-20 20:00:00,104,null,41632,41632,41632,53,12,0,3768,241,4009
20200415,WA,11100,130828,null,2020-04-15 20:00:00,551,null,141928,141928,141928,53,9,0,3719,311,4030
20200414,WA,10789,127109,null,2020-04-14 20:00:00,542,null,137898,137898,137898,53,16,0,3828,202,4030
20200416,WA,11343,134751,null,2020-04-16 20:00:00,571,null,146094,146094,146094,53,20,0,3923,243,4166
20200313,WA,702,14598,null,2020-03-13 20:00:00,47,null,15300,15300,15300,53,3,0,4027,151,4178
20200428,WA,13686,165993,null,2020-04-28 20:00:00,765,null,179679,179679,179679,53,16,0,4037,165,4202
20200410,WA,9941,116396,null,2020-04-10 20:00:00,476,null,126337,126337,126337,53,17,0,3852,449,4301
20200505,WA,15462,200858,null,2020-05-05 20:00:00,841,null,216320,216320,216320,53,7,0,4038,277,4315
20200417,WA,11673,138771,null,2020-04-17 20:00:00,585,null,150444,150444,150444,53,14,0,4020,330,4350
20200319,WA,1563,36060,null,2020-03-19 20:00:00,92,null,37623,37623,37623,53,10,0,4218,149,4367
20200327,WA,4305,65887,null,2020-03-27 20:00:00,199,null,70192,70192,70192,53,16,0,3900,483,4383
20200422,WA,12785,155179,null,2020-04-22 20:00:00,647,null,167964,167964,167964,53,7,0,4162,235,4397
20200420,WA,12346,146419,null,2020-04-20 20:00:00,629,null,158765,158765,158765,53,14,0,4211,200,4411
20200326,WA,3822,61987,null,2020-03-26 20:00:00,183,null,65809,65809,65809,53,24,0,4058,483,4541
20200317,WA,1240,27368,null,2020-03-17 20:00:00,78,null,28608,28608,28608,53,9,0,4388,173,4561
20200331,WA,6049,78384,null,2020-03-31 20:00:00,262,null,84433,84433,84433,53,14,0,4126,460,4586
20200318,WA,1414,31842,null,2020-03-18 20:00:00,82,null,33256,33256,33256,53,4,0,4474,174,4648
20200401,WA,6540,82557,null,2020-04-01 20:00:00,282,null,89097,89097,89097,53,20,0,4173,491,4664
20200402,WA,6893,86889,null,2020-04-02 20:00:00,310,null,93782,93782,93782,53,28,0,4332,353,4685
20200504,WA,15185,196820,null,2020-05-04 20:00:00,834,null,212005,212005,212005,53,4,0,4508,182,4690
20200408,WA,9214,108847,null,2020-04-08 20:00:00,443,null,118061,118061,118061,53,14,0,4336,355,4691
20200316,WA,1067,22980,null,2020-03-16 20:00:00,69,null,24047,24047,24047,53,12,0,4608,128,4736
20200502,WA,14637,184087,null,2020-05-02 20:00:00,824,null,198724,198724,198724,53,10,0,4433,310,4743
20200421,WA,12550,151017,null,2020-04-21 20:00:00,640,null,163567,163567,163567,53,11,0,4598,204,4802
20200403,WA,7424,91184,null,2020-04-03 20:00:00,338,null,98608,98608,98608,53,28,0,4295,531,4826
20200406,WA,8523,99837,null,2020-04-06 20:00:00,407,null,108360,108360,108360,53,21,0,4551,342,4893
20200330,WA,5589,74258,null,2020-03-30 20:00:00,248,null,79847,79847,79847,53,11,0,4470,468,4938
20200407,WA,8859,104511,null,2020-04-07 20:00:00,429,null,113370,113370,113370,53,22,0,4674,336,5010
20200325,WA,3339,57929,null,2020-03-25 20:00:00,159,null,61268,61268,61268,53,13,0,4588,462,5050
20200323,WA,2496,48492,null,2020-03-23 20:00:00,137,null,50988,50988,50988,53,11,0,4852,212,5064
20200509,WA,16388,219447,null,2020-05-09 20:00:00,905,3450,235835,235835,235835,53,14,3450,4998,157,5155
20200324,WA,2877,53341,null,2020-03-24 20:00:00,146,null,56218,56218,56218,53,9,0,4849,381,5230
20200430,WA,14070,173730,null,2020-04-30 20:00:00,801,null,187800,187800,187800,53,15,0,5057,228,5285
20200507,WA,15905,208908,null,2020-05-07 20:00:00,870,null,224813,224813,224813,53,8,0,5049,311,5360
20200508,WA,16231,214449,null,2020-05-08 20:00:00,891,null,230680,230680,230680,53,21,0,5541,326,5867
20200511,WA,16891,231984,null,2020-05-11 20:00:00,931,null,248875,248875,248875,53,10,0,5669,217,5886
20200501,WA,14327,179654,null,2020-05-01 20:00:00,814,null,193981,193981,193981,53,13,0,5924,257,6181
20200510,WA,16674,226315,null,2020-05-10 20:00:00,921,null,242989,242989,242989,53,16,0,6868,286,7154
20200503,WA,15003,192312,null,2020-05-03 20:00:00,830,null,207315,207315,207315,53,6,0,8225,366,8591
20200122,WA,1,null,null,2020-01-22 21:00:00,null,null,1,1,1,53,null,null,null,null,null
20200330,WI,1221,15856,null,2020-03-30 20:00:00,14,null,17077,17077,17077,55,1,0,-694,109,-585
20200314,WI,19,169,null,2020-03-14 20:00:00,null,null,188,188,188,55,0,0,0,0,0
20200308,WI,1,31,12,2020-03-08 20:00:00,null,null,44,32,32,55,0,0,0,0,0
20200307,WI,1,31,12,2020-03-07 21:00:00,null,null,44,32,32,55,0,0,0,0,0
20200305,WI,1,19,6,2020-03-05 21:00:00,null,null,26,20,20,55,0,0,0,0,0
20200310,WI,2,36,null,2020-03-10 20:00:00,null,null,38,38,38,55,0,0,0,1,1
20200309,WI,1,36,null,2020-03-09 20:00:00,null,null,37,37,37,55,0,0,5,0,5
20200311,WI,3,43,null,2020-03-11 20:00:00,null,null,46,46,46,55,0,0,7,1,8
20200306,WI,1,31,12,2020-03-06 21:00:00,null,null,44,32,32,55,0,0,12,0,12
20200312,WI,8,84,null,2020-03-12 20:00:00,null,null,92,92,92,55,0,0,41,5,46
20200313,WI,19,169,null,2020-03-13 20:00:00,null,null,188,188,188,55,0,0,85,11,96
20200315,WI,33,313,null,2020-03-15 20:00:00,null,null,346,346,346,55,0,0,144,14,158
20200316,WI,47,504,null,2020-03-16 20:00:00,null,null,551,551,551,55,0,0,191,14,205
20200317,WI,72,1038,null,2020-03-17 20:00:00,null,null,1110,1110,1110,55,0,0,534,25,559
20200318,WI,106,1577,null,2020-03-18 20:00:00,null,null,1683,1683,1683,55,0,0,539,34,573
20200319,WI,155,2192,null,2020-03-19 20:00:00,null,null,2347,2347,2347,55,0,0,615,49,664
20200323,WI,416,7050,null,2020-03-23 20:00:00,5,null,7466,7466,7466,55,1,0,820,31,851
20200413,WI,3428,36769,273,2020-04-13 20:00:00,154,993,40470,40197,40197,55,10,19,853,87,940
20200324,WI,457,8237,null,2020-03-24 20:00:00,5,null,8694,8694,8694,55,0,0,1187,41,1228
20200321,WI,281,4628,null,2020-03-21 20:00:00,4,null,4909,4909,4909,55,1,0,1173,75,1248
20200320,WI,206,3455,null,2020-03-20 20:00:00,3,null,3661,3661,3661,55,3,0,1263,51,1314
20200414,WI,3555,37997,277,2020-04-14 20:00:00,170,1049,41829,41552,41552,55,16,56,1228,127,1355
20200421,WI,4620,47841,219,2020-04-21 20:00:00,242,1252,52680,52461,52461,55,12,41,1238,121,1359
20200412,WI,3341,35916,null,2020-04-12 20:00:00,144,974,39257,39257,39257,55,7,24,1236,128,1364
20200420,WI,4499,46603,237,2020-04-20 20:00:00,230,1211,51339,51102,51102,55,10,21,1280,153,1433
20200409,WI,2885,31424,null,2020-04-09 20:00:00,111,843,34309,34309,34309,55,12,53,1309,129,1438
20200329,WI,1112,16550,null,2020-03-29 20:00:00,13,null,17662,17662,17662,55,0,0,1318,123,1441
20200405,WI,2267,25169,null,2020-04-05 20:00:00,68,624,27436,27436,27436,55,12,36,1310,155,1465
20200415,WI,3721,39326,280,2020-04-15 20:00:00,182,1091,43327,43047,43047,55,12,42,1329,166,1495
20200419,WI,4346,45323,248,2020-04-19 20:00:00,220,1190,49917,49669,49669,55,9,14,1361,147,1508
20200417,WI,4045,42365,198,2020-04-17 20:00:00,205,1153,46608,46410,46410,55,8,32,1391,170,1561
20200406,WI,2440,26574,null,2020-04-06 20:00:00,77,668,29014,29014,29014,55,9,44,1405,173,1578
20200411,WI,3213,34680,null,2020-04-11 20:00:00,137,950,37893,37893,37893,55,9,46,1455,145,1600
20200326,WI,707,11583,null,2020-03-26 20:00:00,8,null,12290,12290,12290,55,1,0,1494,122,1616
20200401,WI,1550,18819,null,2020-04-01 20:00:00,24,398,20369,20369,20369,55,8,61,1444,199,1643
20200331,WI,1351,17375,null,2020-03-31 20:00:00,16,337,18726,18726,18726,55,2,337,1519,130,1649
20200402,WI,1730,20317,null,2020-04-02 20:00:00,31,461,22047,22047,22047,55,7,63,1498,180,1678
20200404,WI,2112,23859,null,2020-04-04 20:00:00,56,588,25971,25971,25971,55,19,101,1482,200,1682
20200327,WI,842,13140,null,2020-03-27 20:00:00,13,null,13982,13982,13982,55,5,0,1557,135,1692
20200322,WI,385,6230,null,2020-03-22 20:00:00,4,null,6615,6615,6615,55,0,0,1602,104,1706
20200418,WI,4199,43962,229,2020-04-18 20:00:00,211,1176,48390,48161,48161,55,6,23,1597,154,1751
20200408,WI,2756,30115,null,2020-04-08 20:00:00,99,790,32871,32871,32871,55,7,45,1603,178,1781
20200416,WI,3875,40974,218,2020-04-16 20:00:00,197,1121,45067,44849,44849,55,15,30,1648,154,1802
20200422,WI,4845,49502,229,2020-04-22 20:00:00,246,1302,54576,54347,54347,55,4,50,1661,225,1886
20200325,WI,585,10089,null,2020-03-25 20:00:00,7,null,10674,10674,10674,55,2,0,1852,128,1980
20200410,WI,3068,33225,null,2020-04-10 20:00:00,128,904,36293,36293,36293,55,17,61,1801,183,1984
20200407,WI,2578,28512,null,2020-04-07 20:00:00,92,745,31090,31090,31090,55,15,77,1938,138,2076
20200423,WI,5052,51456,201,2020-04-23 20:00:00,257,1318,56709,56508,56508,55,11,16,1954,207,2161
20200328,WI,989,15232,null,2020-03-28 20:00:00,13,null,16221,16221,16221,55,0,0,2092,147,2239
20200403,WI,1912,22377,null,2020-04-03 20:00:00,37,487,24289,24289,24289,55,6,26,2060,182,2242
20200427,WI,6081,61311,204,2020-04-27 20:00:00,281,1415,67596,67392,67392,55,9,18,2076,170,2246
20200426,WI,5911,59235,197,2020-04-26 20:00:00,272,1397,65343,65146,65146,55,6,21,2097,224,2321
20200428,WI,6289,63535,193,2020-04-28 20:00:00,300,1456,70017,69824,69824,55,19,41,2224,208,2432
20200503,WI,7964,77997,231,2020-05-03 20:00:00,339,1608,86192,85961,85961,55,5,17,2427,304,2731
20200504,WI,8236,80467,226,2020-05-04 20:00:00,340,1621,88929,88703,88703,55,1,13,2470,272,2742
20200425,WI,5687,57138,241,2020-04-25 20:00:00,266,1376,63066,62825,62825,55,4,23,2565,331,2896
20200511,WI,10418,108033,180,2020-05-11 20:00:00,409,1846,118631,118451,118451,55,9,26,2870,199,3069
20200430,WI,6854,69394,195,2020-04-30 20:00:00,316,1512,76443,76248,76248,55,8,23,2764,334,3098
20200429,WI,6520,66630,227,2020-04-29 20:00:00,308,1489,73377,73150,73150,55,8,33,3095,231,3326
20200502,WI,7660,75570,231,2020-05-02 20:00:00,334,1591,83461,83230,83230,55,7,47,3004,346,3350
20200424,WI,5356,54573,206,2020-04-24 20:00:00,262,1353,60135,59929,59929,55,5,35,3117,304,3421
20200510,WI,10219,105163,182,2020-05-10 20:00:00,400,1820,115564,115382,115382,55,2,14,3228,280,3508
20200501,WI,7314,72566,218,2020-05-01 20:00:00,327,1544,80098,79880,79880,55,11,32,3172,460,3632
20200505,WI,8566,83967,236,2020-05-05 20:00:00,353,1663,92769,92533,92533,55,13,42,3500,330,3830
20200506,WI,8901,87826,212,2020-05-06 20:00:00,362,1694,96939,96727,96727,55,9,31,3859,335,4194
20200508,WI,9590,97265,204,2020-05-08 20:00:00,384,1767,107059,106855,106855,55,10,35,4230,375,4605
20200509,WI,9939,101935,204,2020-05-09 20:00:00,398,1806,112078,111874,111874,55,14,39,4670,349,5019
20200507,WI,9215,93035,219,2020-05-07 20:00:00,374,1732,102469,102250,102250,55,12,38,5209,314,5523
20200304,WI,1,19,6,2020-03-04 21:00:00,null,null,26,20,20,55,null,null,null,null,null
20200317,WV,0,80,4,2020-03-17 20:00:00,0,null,84,80,80,54,0,0,0,0,0
20200310,WV,0,2,3,2020-03-10 20:00:00,null,null,5,2,2,54,0,0,0,0,0
20200309,WV,0,2,3,2020-03-09 20:00:00,null,null,5,2,2,54,0,0,0,0,0
20200308,WV,0,2,3,2020-03-08 20:00:00,null,null,5,2,2,54,0,0,0,0,0
20200311,WV,0,3,2,2020-03-11 20:00:00,null,null,5,3,3,54,0,0,1,0,1
20200307,WV,0,2,3,2020-03-07 21:00:00,null,null,5,2,2,54,0,0,1,0,1
20200312,WV,0,7,1,2020-03-12 20:00:00,null,null,8,7,7,54,0,0,4,0,4
20200314,WV,0,26,5,2020-03-14 20:00:00,null,null,31,26,26,54,0,0,9,0,9
20200313,WV,0,17,4,2020-03-13 20:00:00,null,null,21,17,17,54,0,0,10,0,10
20200315,WV,0,38,1,2020-03-15 20:00:00,0,null,39,38,38,54,0,0,12,0,12
20200429,WV,1095,41976,null,2020-04-29 20:00:00,38,null,43071,43071,43071,54,1,0,0,16,16
20200428,WV,1079,41976,null,2020-04-28 20:00:00,37,null,43055,43055,43055,54,1,0,0,16,16
20200319,WV,2,143,3,2020-03-19 20:00:00,0,null,148,145,145,54,0,0,21,1,22
20200316,WV,0,80,4,2020-03-16 20:00:00,0,null,84,80,80,54,0,0,42,0,42
20200318,WV,1,122,14,2020-03-18 20:00:00,0,null,137,123,123,54,0,0,42,1,43
20200322,WV,12,385,1,2020-03-22 20:00:00,0,1,398,397,397,54,0,0,55,1,56
20200323,WV,16,444,4,2020-03-23 20:00:00,0,1,464,460,460,54,0,0,59,4,63
20200320,WV,7,219,13,2020-03-20 20:00:00,0,null,239,226,226,54,0,0,76,5,81
20200321,WV,11,330,2,2020-03-21 20:00:00,0,1,343,341,341,54,0,1,111,4,115
20200325,WV,39,759,6,2020-03-25 20:00:00,0,1,804,798,798,54,0,0,149,19,168
20200324,WV,20,610,0,2020-03-24 20:00:00,0,1,630,630,630,54,0,0,166,4,170
20200326,WV,51,1031,19,2020-03-26 20:00:00,0,1,1101,1082,1082,54,0,0,272,12,284
20200330,WV,126,2984,0,2020-03-30 20:00:00,1,1,3110,3110,3110,54,1,0,279,13,292
20200417,WV,754,17927,null,2020-04-17 20:00:00,13,null,18681,18681,18681,54,0,0,360,15,375
20200414,WV,640,16398,null,2020-04-14 20:00:00,9,164,17038,17038,17038,54,0,0,369,14,383
20200329,WV,113,2705,0,2020-03-29 20:00:00,0,1,2818,2818,2818,54,0,0,374,17,391
20200413,WV,626,16029,null,2020-04-13 20:00:00,9,164,16655,16655,16655,54,1,164,383,15,398
20200401,WV,191,4384,null,2020-04-01 20:00:00,1,1,4575,4575,4575,54,0,0,403,29,432
20200408,WV,462,12083,null,2020-04-08 20:00:00,4,null,12545,12545,12545,54,0,0,436,50,486
20200328,WV,96,2331,6,2020-03-28 20:00:00,0,1,2433,2427,2427,54,0,0,552,20,572
20200419,WV,863,19168,null,2020-04-19 20:00:00,18,null,20031,20031,20031,54,2,0,513,78,591
20200421,WV,914,21849,null,2020-04-21 20:00:00,26,null,22763,22763,22763,54,2,0,596,12,608
20200415,WV,702,16954,null,2020-04-15 20:00:00,10,164,17656,17656,17656,54,1,0,556,62,618
20200416,WV,739,17567,null,2020-04-16 20:00:00,13,null,18306,18306,18306,54,3,0,613,37,650
20200410,WV,554,14001,null,2020-04-10 20:00:00,5,null,14555,14555,14555,54,0,0,661,31,692
20200418,WV,785,18655,null,2020-04-18 20:00:00,16,null,19440,19440,19440,54,3,0,728,31,759
20200327,WV,76,1779,43,2020-03-27 20:00:00,0,1,1898,1855,1855,54,0,0,748,25,773
20200412,WV,611,15646,null,2020-04-12 20:00:00,8,null,16257,16257,16257,54,3,0,771,34,805
20200511,WV,1366,62103,null,2020-05-11 20:00:00,54,null,63469,63469,63469,54,0,0,819,6,825
20200403,WV,237,6130,null,2020-04-03 20:00:00,2,1,6367,6367,6367,54,0,0,854,20,874
20200411,WV,577,14875,null,2020-04-11 20:00:00,5,null,15452,15452,15452,54,0,0,874,23,897
20200402,WV,217,5276,null,2020-04-02 20:00:00,2,1,5493,5493,5493,54,1,0,892,26,918
20200506,WV,1248,54536,null,2020-05-06 20:00:00,50,null,55784,55784,55784,54,0,0,951,10,961
20200331,WV,162,3981,null,2020-03-31 20:00:00,1,1,4143,4143,4143,54,0,0,997,36,1033
20200406,WV,345,9595,null,2020-04-06 20:00:00,4,null,9940,9940,9940,54,1,0,1081,21,1102
20200405,WV,324,8514,null,2020-04-05 20:00:00,3,null,8838,8838,8838,54,1,0,1110,42,1152
20200409,WV,523,13340,null,2020-04-09 20:00:00,5,null,13863,13863,13863,54,1,0,1257,61,1318
20200404,WV,282,7404,null,2020-04-04 20:00:00,2,null,7686,7686,7686,54,0,0,1274,45,1319
20200430,WV,1118,43423,null,2020-04-30 20:00:00,41,null,44541,44541,44541,54,3,0,1447,23,1470
20200509,WV,1335,59662,null,2020-05-09 20:00:00,53,null,60997,60997,60997,54,2,0,1536,25,1561
20200505,WV,1238,53585,null,2020-05-05 20:00:00,50,null,54823,54823,54823,54,0,0,1552,32,1584
20200504,WV,1206,52033,null,2020-05-04 20:00:00,50,null,53239,53239,53239,54,0,0,1586,15,1601
20200510,WV,1360,61284,null,2020-05-10 20:00:00,54,null,62644,62644,62644,54,1,0,1622,25,1647
20200507,WV,1287,56234,null,2020-05-07 20:00:00,51,null,57521,57521,57521,54,1,0,1698,39,1737
20200424,WV,988,28823,null,2020-04-24 20:00:00,32,null,29811,29811,29811,54,3,0,1885,21,1906
20200508,WV,1310,58126,null,2020-05-08 20:00:00,51,null,59436,59436,59436,54,0,0,1892,23,1915
20200423,WV,967,26938,null,2020-04-23 20:00:00,29,null,27905,27905,27905,54,3,0,2041,28,2069
20200407,WV,412,11647,null,2020-04-07 20:00:00,4,null,12059,12059,12059,54,0,0,2052,67,2119
20200420,WV,902,21253,null,2020-04-20 20:00:00,24,null,22155,22155,22155,54,6,0,2085,39,2124
20200502,WV,1169,47977,null,2020-05-02 20:00:00,48,null,49146,49146,49146,54,2,0,2269,33,2302
20200501,WV,1136,45708,null,2020-05-01 20:00:00,46,null,46844,46844,46844,54,5,0,2285,18,2303
20200503,WV,1191,50447,null,2020-05-03 20:00:00,50,null,51638,51638,51638,54,2,0,2470,22,2492
20200422,WV,939,24897,null,2020-04-22 20:00:00,26,null,25836,25836,25836,54,0,0,3048,25,3073
20200425,WV,1020,31946,null,2020-04-25 20:00:00,32,null,32966,32966,32966,54,0,0,3123,32,3155
20200427,WV,1063,41976,null,2020-04-27 20:00:00,36,null,43039,43039,43039,54,2,0,3957,19,3976
20200426,WV,1044,38019,null,2020-04-26 20:00:00,34,null,39063,39063,39063,54,2,0,6073,24,6097
20200306,WV,0,1,4,2020-03-06 21:00:00,null,null,5,1,1,54,null,null,null,null,null
20200423,WY,326,7241,null,2020-04-23 20:00:00,7,52,7567,7567,7567,56,1,0,-60,4,-56
20200417,WY,296,6131,null,2020-04-17 20:00:00,2,43,6427,6427,6427,56,0,0,0,0,0
20200414,WY,275,5689,null,2020-04-14 20:00:00,1,43,5964,5964,5964,56,0,2,0,0,0
20200412,WY,261,5198,null,2020-04-12 20:00:00,0,40,5459,5459,5459,56,0,3,0,0,0
20200316,WY,3,null,null,2020-03-16 20:00:00,null,null,3,3,3,56,0,0,0,0,0
20200313,WY,1,null,null,2020-03-13 20:00:00,null,null,1,1,1,56,0,0,0,0,0
20200311,WY,0,null,null,2020-03-11 20:00:00,null,null,0,0,0,56,0,0,0,0,0
20200310,WY,0,0,0,2020-03-10 20:00:00,null,null,0,0,0,56,0,0,0,0,0
20200309,WY,0,null,null,2020-03-09 20:00:00,null,null,0,0,0,56,0,0,0,0,0
20200308,WY,0,null,null,2020-03-08 20:00:00,null,null,0,0,0,56,0,0,0,0,0
20200511,WY,662,11403,null,2020-05-11 20:00:00,7,66,12065,12065,12065,56,0,1,0,1,1
20200322,WY,24,438,null,2020-03-22 20:00:00,null,null,462,462,462,56,0,0,0,1,1
20200315,WY,3,null,null,2020-03-15 20:00:00,null,null,3,3,3,56,0,0,0,1,1
20200314,WY,2,null,null,2020-03-14 20:00:00,null,null,2,2,2,56,0,0,0,1,1
20200312,WY,1,null,null,2020-03-12 20:00:00,null,null,1,1,1,56,0,0,0,1,1
20200422,WY,322,7301,null,2020-04-22 20:00:00,6,52,7623,7623,7623,56,0,0,0,2,2
20200508,WY,635,11403,null,2020-05-08 20:00:00,7,60,12038,12038,12038,56,0,1,0,4,4
20200427,WY,370,7797,null,2020-04-27 20:00:00,7,54,8167,8167,8167,56,0,0,0,8,8
20200509,WY,644,11403,null,2020-05-09 20:00:00,7,64,12047,12047,12047,56,0,4,0,9,9
20200426,WY,362,7797,null,2020-04-26 20:00:00,7,54,8159,8159,8159,56,0,0,0,13,13
20200510,WY,661,11403,null,2020-05-10 20:00:00,7,65,12064,12064,12064,56,0,1,0,17,17
20200507,WY,631,11403,null,2020-05-07 20:00:00,7,59,12034,12034,12034,56,0,-1,0,27,27
20200408,WY,221,3843,null,2020-04-08 20:00:00,0,33,4064,4064,4064,56,0,0,54,5,59
20200320,WY,19,331,null,2020-03-20 20:00:00,null,null,350,350,350,56,0,0,60,1,61
20200407,WY,216,3789,null,2020-04-07 20:00:00,0,33,4005,4005,4005,56,0,10,70,6,76
20200329,WY,86,1554,null,2020-03-29 20:00:00,0,15,1640,1640,1640,56,0,1,79,4,83
20200409,WY,230,3920,null,2020-04-09 20:00:00,0,34,4150,4150,4150,56,0,1,77,9,86
20200318,WY,15,178,null,2020-03-18 20:00:00,null,null,193,193,193,56,0,0,83,5,88
20200418,WY,305,6217,null,2020-04-18 20:00:00,2,50,6522,6522,6522,56,0,7,86,9,95
20200319,WY,18,271,null,2020-03-19 20:00:00,null,null,289,289,289,56,0,0,93,3,96
20200416,WY,296,6131,null,2020-04-16 20:00:00,2,43,6427,6427,6427,56,0,0,89,9,98
20200425,WY,349,7797,null,2020-04-25 20:00:00,7,54,8146,8146,8146,56,0,0,101,0,101
20200317,WY,10,95,null,2020-03-17 20:00:00,null,null,105,105,105,56,0,0,95,7,102
20200420,WY,313,7073,null,2020-04-20 20:00:00,2,51,7386,7386,7386,56,0,1,101,4,105
20200405,WY,197,3040,null,2020-04-05 20:00:00,0,23,3237,3237,3237,56,0,0,95,10,105
20200326,WY,53,1052,null,2020-03-26 20:00:00,null,null,1105,1105,1105,56,0,0,98,9,107
20200321,WY,23,438,null,2020-03-21 20:00:00,null,null,461,461,461,56,0,0,107,4,111
20200324,WY,29,710,null,2020-03-24 20:00:00,null,null,739,739,739,56,0,0,118,3,121
20200323,WY,26,592,null,2020-03-23 20:00:00,null,null,618,618,618,56,0,0,154,2,156
20200331,WY,109,1999,null,2020-03-31 20:00:00,0,17,2108,2108,2108,56,0,0,159,15,174
20200327,WY,70,1211,null,2020-03-27 20:00:00,0,11,1281,1281,1281,56,0,11,159,17,176
20200503,WY,579,9640,null,2020-05-03 20:00:00,7,60,10219,10219,10219,56,0,2,177,13,190
20200430,WY,544,8902,null,2020-04-30 20:00:00,7,56,9446,9446,9446,56,0,0,221,8,229
20200504,WY,586,9868,null,2020-05-04 20:00:00,7,60,10454,10454,10454,56,0,0,228,7,235
20200421,WY,320,7301,null,2020-04-21 20:00:00,6,52,7621,7621,7621,56,4,1,228,7,235
20200401,WY,130,2218,null,2020-04-01 20:00:00,0,18,2348,2348,2348,56,0,1,219,21,240
20200402,WY,150,2439,null,2020-04-02 20:00:00,0,19,2589,2589,2589,56,0,1,221,20,241
20200501,WY,559,9136,null,2020-05-01 20:00:00,7,56,9695,9695,9695,56,0,0,234,15,249
20200325,WY,44,954,null,2020-03-25 20:00:00,null,null,998,998,998,56,0,0,244,15,259
20200404,WY,187,2945,null,2020-04-04 20:00:00,0,23,3132,3132,3132,56,0,2,241,25,266
20200328,WY,82,1475,null,2020-03-28 20:00:00,0,14,1557,1557,1557,56,0,3,264,12,276
20200403,WY,162,2704,null,2020-04-03 20:00:00,0,21,2866,2866,2866,56,0,2,265,12,277
20200330,WY,94,1840,null,2020-03-30 20:00:00,0,17,1934,1934,1934,56,0,2,286,8,294
20200502,WY,566,9463,null,2020-05-02 20:00:00,7,58,10029,10029,10029,56,0,2,327,7,334
20200415,WY,287,6042,null,2020-04-15 20:00:00,2,43,6329,6329,6329,56,1,0,353,12,365
20200428,WY,389,8226,null,2020-04-28 20:00:00,7,56,8615,8615,8615,56,0,2,429,19,448
20200505,WY,596,10319,null,2020-05-05 20:00:00,7,60,10915,10915,10915,56,0,0,451,10,461
20200411,WY,261,5198,null,2020-04-11 20:00:00,0,37,5459,5459,5459,56,0,0,462,8,470
20200424,WY,349,7696,null,2020-04-24 20:00:00,7,54,8045,8045,8045,56,0,2,455,23,478
20200413,WY,275,5689,null,2020-04-13 20:00:00,1,41,5964,5964,5964,56,1,1,491,14,505
20200429,WY,536,8681,null,2020-04-29 20:00:00,7,56,9217,9217,9217,56,0,0,455,147,602
20200406,WY,210,3719,null,2020-04-06 20:00:00,0,23,3929,3929,3929,56,0,0,679,13,692
20200419,WY,309,6972,null,2020-04-19 20:00:00,2,50,7281,7281,7281,56,0,0,755,4,759
20200410,WY,253,4736,null,2020-04-10 20:00:00,0,37,4989,4989,4989,56,0,3,816,23,839
20200506,WY,604,11403,null,2020-05-06 20:00:00,7,60,12007,12007,12007,56,0,0,1084,8,1092
20200307,WY,0,null,null,2020-03-07 21:00:00,null,null,0,0,0,56,null,null,null,null,null
